"","PortID","PortName","ExpTotValue","ExpContainerValue","ExpContainerWeight","time","Year","State","PortNameTiCase","County_GEOID","CountyName","ImpContainerValue","ImpContainerWt","TotPortWt","TotPortContainerVal","TotPortVal","rnkTotValue","rnkTotPortWt","rnkExpValue","rnkExpContainerWt","rnkImpContainerVal","rnkImpContainerWt"
"1","3003","ABERDEEN-HOQUIAM, WA",2983868599,10900873,1290549,"2013-12","2013"," WA","Aberdeen","53027","Grays Harbor",7608231,1325647,2616196,18509104,2991476830,55,71,41,59,61,74
"2","3003","ABERDEEN-HOQUIAM, WA",3573834249,2800948,432628,"2014-12","2014"," WA","Aberdeen","53027","Grays Harbor",21354572,37105488,37538116,24155520,3595188821,55,71,41,59,61,74
"3","3003","ABERDEEN-HOQUIAM, WA",2497939925,7085326,752335,"2015-12","2015"," WA","Aberdeen","53027","Grays Harbor",5857741,23826204,24578539,12943067,2503797666,55,71,41,59,61,74
"4","3003","ABERDEEN-HOQUIAM, WA",1770368317,210555661,16316956,"2016-12","2016"," WA","Aberdeen","53027","Grays Harbor",21200512,2113588,18430544,231756173,1791568829,55,71,41,59,61,74
"5","3003","ABERDEEN-HOQUIAM, WA",1642030202,327585453,25089802,"2017-12","2017"," WA","Aberdeen","53027","Grays Harbor",198437959,16898482,41988284,526023412,1840468161,55,71,41,59,61,74
"6","3003","ABERDEEN-HOQUIAM, WA",1472434776,306735533,22164692,"2018-12","2018"," WA","Aberdeen","53027","Grays Harbor",712297,161378,22326070,307447830,1473147073,55,71,41,59,61,74
"7","3003","ABERDEEN-HOQUIAM, WA",2077504864,604856492,67374300,"2019-12","2019"," WA","Aberdeen","53027","Grays Harbor",3186839,606707,67981007,608043331,2080691703,55,71,41,59,61,74
"8","3003","ABERDEEN-HOQUIAM, WA",980846967,2788162,193726,"2020-12","2020"," WA","Aberdeen","53027","Grays Harbor",619183,56297,250023,3407345,981466150,55,71,41,59,61,74
"9","3003","ABERDEEN-HOQUIAM, WA",917254950,337269,248598,"2021-12","2021"," WA","Aberdeen","53027","Grays Harbor",963713,104754,353352,1300982,918218663,55,71,41,59,61,74
"10","1002","ALBANY, NY",770840441,3059098,226803,"2013-12","2013"," NY","Albany","36001","Albany",21326936,35498257,35725060,24386034,792167377,78,57,62,83,57,48
"11","1002","ALBANY, NY",1295278395,6593754,7553043,"2014-12","2014"," NY","Albany","36001","Albany",14672895,119574461,127127504,21266649,1309951290,78,57,62,83,57,48
"12","1002","ALBANY, NY",783872033,3199468,174641,"2015-12","2015"," NY","Albany","36001","Albany",24571574,136174082,136348723,27771042,808443607,78,57,62,83,57,48
"13","1002","ALBANY, NY",283136873,7388662,468460,"2016-12","2016"," NY","Albany","36001","Albany",44370207,9272733,9741193,51758869,327507080,78,57,62,83,57,48
"14","1002","ALBANY, NY",275877022,9619609,810489,"2017-12","2017"," NY","Albany","36001","Albany",99635113,140992535,141803024,109254722,375512135,78,57,62,83,57,48
"15","1002","ALBANY, NY",263098475,2625793,317712,"2018-12","2018"," NY","Albany","36001","Albany",107914249,95990553,96308265,110540042,371012724,78,57,62,83,57,48
"16","1002","ALBANY, NY",176683334,25250281,783147,"2019-12","2019"," NY","Albany","36001","Albany",4155873,39240011,40023158,29406154,180839207,78,57,62,83,57,48
"17","1002","ALBANY, NY",152936369,66707159,2693436,"2020-12","2020"," NY","Albany","36001","Albany",20994554,107980415,110673851,87701713,173930923,78,57,62,83,57,48
"18","1002","ALBANY, NY",257162226,90761217,3635045,"2021-12","2021"," NY","Albany","36001","Albany",58598316,61353872,64988917,149359533,315760542,78,57,62,83,57,48
"19","0708","ALEXANDRIA BAY, NY",6734770855,5364138,315746,"2013-12","2013"," NY","Alexandria Bay","36045","Jefferson",19736571,33464,349210,25100709,6754507426,34,108,74,90,82,106
"20","0708","ALEXANDRIA BAY, NY",6717512614,1136930,133260,"2014-12","2014"," NY","Alexandria Bay","36045","Jefferson",2035018,11937,145197,3171948,6719547632,34,108,74,90,82,106
"21","0708","ALEXANDRIA BAY, NY",6414545279,135570,39990,"2015-12","2015"," NY","Alexandria Bay","36045","Jefferson",4723907,15775,55765,4859477,6419269186,34,108,74,90,82,106
"22","0708","ALEXANDRIA BAY, NY",6249748808,11962182,1823780,"2016-12","2016"," NY","Alexandria Bay","36045","Jefferson",1789113,136124,1959904,13751295,6251537921,34,108,74,90,82,106
"23","0708","ALEXANDRIA BAY, NY",6315900384,3250990,754605,"2017-12","2017"," NY","Alexandria Bay","36045","Jefferson",486373,29405,784010,3737363,6316386757,34,108,74,90,82,106
"24","0708","ALEXANDRIA BAY, NY",7116642484,8602100,1289723,"2018-12","2018"," NY","Alexandria Bay","36045","Jefferson",2172426,139429,1429152,10774526,7118814910,34,108,74,90,82,106
"25","0708","ALEXANDRIA BAY, NY",6937378116,5611107,1177390,"2019-12","2019"," NY","Alexandria Bay","36045","Jefferson",2201538,189893,1367283,7812645,6939579654,34,108,74,90,82,106
"26","0708","ALEXANDRIA BAY, NY",6746482414,1637515,504782,"2020-12","2020"," NY","Alexandria Bay","36045","Jefferson",11738876,164866,669648,13376391,6758221290,34,108,74,90,82,106
"27","0708","ALEXANDRIA BAY, NY",8529401603,443413,33127,"2021-12","2021"," NY","Alexandria Bay","36045","Jefferson",4310721,172247,205374,4754134,8533712324,34,108,74,90,82,106
"28","5402","ALEXANDRIA, VA",404037,260304,805158,"2013-12","2013"," VA","Alexandria","51059","Fairfax",0,0,805158,260304,404037,121,121,120,101,141,136
"29","5402","ALEXANDRIA, VA",78904687,242074,828899,"2014-12","2014"," VA","Alexandria","51059","Fairfax",181515,10836,839735,423589,79086202,121,121,120,101,141,136
"30","5402","ALEXANDRIA, VA",89871720,36366,24962,"2015-12","2015"," VA","Alexandria","51059","Fairfax",0,0,24962,36366,89871720,121,121,120,101,141,136
"31","5402","ALEXANDRIA, VA",263401,95425,116598,"2016-12","2016"," VA","Alexandria","51059","Fairfax",0,0,116598,95425,263401,121,121,120,101,141,136
"32","5402","ALEXANDRIA, VA",39642383,180764,427444,"2017-12","2017"," VA","Alexandria","51059","Fairfax",245009,93943,521387,425773,39887392,121,121,120,101,141,136
"33","5402","ALEXANDRIA, VA",65701039,677043,45660,"2018-12","2018"," VA","Alexandria","51059","Fairfax",16956,54,45714,693999,65717995,121,121,120,101,141,136
"34","5402","ALEXANDRIA, VA",584846,277934,6170,"2019-12","2019"," VA","Alexandria","51059","Fairfax",0,0,6170,277934,584846,121,121,120,101,141,136
"35","5402","ALEXANDRIA, VA",88031,0,0,"2020-12","2020"," VA","Alexandria","51059","Fairfax",0,0,0,0,88031,121,121,120,101,141,136
"36","5402","ALEXANDRIA, VA",10032,0,0,"2021-12","2021"," VA","Alexandria","51059","Fairfax",0,0,0,0,10032,121,121,120,101,141,136
"37","3843","ALPENA, MI",17397494,0,0,"2013-12","2013"," MI","Alpena","26007","Alpena",0,0,0,0,17397494,144,157,145,149,148,144
"38","3843","ALPENA, MI",12942558,0,0,"2014-12","2014"," MI","Alpena","26007","Alpena",0,0,0,0,12942558,144,157,145,149,148,144
"39","3843","ALPENA, MI",10983469,0,0,"2015-12","2015"," MI","Alpena","26007","Alpena",0,0,0,0,10983469,144,157,145,149,148,144
"40","3843","ALPENA, MI",7682141,0,0,"2016-12","2016"," MI","Alpena","26007","Alpena",10393,17313,17313,10393,7692534,144,157,145,149,148,144
"41","3843","ALPENA, MI",5791944,45290,2188,"2017-12","2017"," MI","Alpena","26007","Alpena",0,0,2188,45290,5791944,144,157,145,149,148,144
"42","3843","ALPENA, MI",10714047,0,0,"2018-12","2018"," MI","Alpena","26007","Alpena",33066,3898,3898,33066,10747113,144,157,145,149,148,144
"43","3843","ALPENA, MI",2559453,0,0,"2020-12","2020"," MI","Alpena","26007","Alpena",0,0,0,0,2559453,144,157,145,149,148,144
"44","3843","ALPENA, MI",1226389,0,0,"2021-12","2021"," MI","Alpena","26007","Alpena",0,0,0,0,1226389,144,157,145,149,148,144
"45","3010","ANACORTES, WA",2235356802,420720,148771,"2013-12","2013"," WA","Anacortes","53057","Skagit",80025,825753,974524,500745,2235436827,67,80,73,63,96,95
"46","3010","ANACORTES, WA",1532170101,492100,74251,"2014-12","2014"," WA","Anacortes","53057","Skagit",275324,1622678,1696929,767424,1532445425,67,80,73,63,96,95
"47","3010","ANACORTES, WA",854265896,194783,57582,"2015-12","2015"," WA","Anacortes","53057","Skagit",271276,8260,65842,466059,854537172,67,80,73,63,96,95
"48","3010","ANACORTES, WA",866488615,315464,70196,"2016-12","2016"," WA","Anacortes","53057","Skagit",54134,25880,96076,369598,866542749,67,80,73,63,96,95
"49","3010","ANACORTES, WA",655043311,147894,336769,"2017-12","2017"," WA","Anacortes","53057","Skagit",9427938,621278,958047,9575832,664471249,67,80,73,63,96,95
"50","3010","ANACORTES, WA",1192784311,12232454,30442959,"2018-12","2018"," WA","Anacortes","53057","Skagit",253318,159055,30602014,12485772,1193037629,67,80,73,63,96,95
"51","3010","ANACORTES, WA",901605039,26658043,65484667,"2019-12","2019"," WA","Anacortes","53057","Skagit",266692,119621,65604288,26924735,901871731,67,80,73,63,96,95
"52","3010","ANACORTES, WA",381933206,260377,26003,"2020-12","2020"," WA","Anacortes","53057","Skagit",16274,3720,29723,276651,381949480,67,80,73,63,96,95
"53","3010","ANACORTES, WA",512790185,55860,26889,"2021-12","2021"," WA","Anacortes","53057","Skagit",412206,39622,66511,468066,513202391,67,80,73,63,96,95
"54","3126","ANCHORAGE, AK",14708691643,100063333,42821683,"2013-12","2013"," AK","Anchorage","02170","Matanuska-Susitna",35292958,36072583,78894266,135356291,14743984601,22,33,21,22,60,56
"55","3126","ANCHORAGE, AK",17186215403,1901133307,738246653,"2014-12","2014"," AK","Anchorage","02170","Matanuska-Susitna",38417075,42068107,780314760,1939550382,17224632478,22,33,21,22,60,56
"56","3126","ANCHORAGE, AK",18191007669,2014769024,778129645,"2015-12","2015"," AK","Anchorage","02170","Matanuska-Susitna",50316004,44308076,822437721,2065085028,18241323673,22,33,21,22,60,56
"57","3126","ANCHORAGE, AK",18121730621,1897098119,742091983,"2016-12","2016"," AK","Anchorage","02170","Matanuska-Susitna",44841647,45448691,787540674,1941939766,18166572268,22,33,21,22,60,56
"58","3126","ANCHORAGE, AK",19366125882,1272901724,458001042,"2017-12","2017"," AK","Anchorage","02170","Matanuska-Susitna",35076577,42285856,500286898,1307978301,19401202459,22,33,21,22,60,56
"59","3126","ANCHORAGE, AK",21189263195,1323501521,530058484,"2018-12","2018"," AK","Anchorage","02170","Matanuska-Susitna",25474957,46391004,576449488,1348976478,21214738152,22,33,21,22,60,56
"60","3126","ANCHORAGE, AK",20418668377,1289767479,472769858,"2019-12","2019"," AK","Anchorage","02170","Matanuska-Susitna",22277464,40866235,513636093,1312044943,20440945841,22,33,21,22,60,56
"61","3126","ANCHORAGE, AK",18938518654,1036853119,391728602,"2020-12","2020"," AK","Anchorage","02170","Matanuska-Susitna",20340980,35557275,427285877,1057194099,18958859634,22,33,21,22,60,56
"62","3126","ANCHORAGE, AK",25064586564,1347665821,614054615,"2021-12","2021"," AK","Anchorage","02170","Matanuska-Susitna",8076445,5279843,619334458,1355742266,25072663009,22,33,21,22,60,56
"63","1301","ANNAPOLIS, MD",18649926,1144424,344009,"2013-12","2013"," MD","Annapolis","24003","Anne Arundel",6833476,1095682,1439691,7977900,25483402,130,100,79,89,79,88
"64","1301","ANNAPOLIS, MD",14042488,3855074,914039,"2014-12","2014"," MD","Annapolis","24003","Anne Arundel",10999898,1043350,1957389,14854972,25042386,130,100,79,89,79,88
"65","1301","ANNAPOLIS, MD",8041320,1591250,329864,"2015-12","2015"," MD","Annapolis","24003","Anne Arundel",3738295,485149,815013,5329545,11779615,130,100,79,89,79,88
"66","1301","ANNAPOLIS, MD",4628047,1861859,719271,"2016-12","2016"," MD","Annapolis","24003","Anne Arundel",20904486,1274796,1994067,22766345,25532533,130,100,79,89,79,88
"67","1301","ANNAPOLIS, MD",22707274,12072096,2537281,"2017-12","2017"," MD","Annapolis","24003","Anne Arundel",5089402,2157647,4694928,17161498,27796676,130,100,79,89,79,88
"68","1301","ANNAPOLIS, MD",13814197,5245662,1093006,"2018-12","2018"," MD","Annapolis","24003","Anne Arundel",3784543,939760,2032766,9030205,17598740,130,100,79,89,79,88
"69","1301","ANNAPOLIS, MD",2819434,260264,49827,"2019-12","2019"," MD","Annapolis","24003","Anne Arundel",3065175,1528890,1578717,3325439,5884609,130,100,79,89,79,88
"70","1301","ANNAPOLIS, MD",16166314,604321,150490,"2020-12","2020"," MD","Annapolis","24003","Anne Arundel",3615235,1274943,1425433,4219556,19781549,130,100,79,89,79,88
"71","1301","ANNAPOLIS, MD",5252808,5193615,225445,"2021-12","2021"," MD","Annapolis","24003","Anne Arundel",5071039,4092627,4318072,10264654,10323847,130,100,79,89,79,88
"72","2901","ASTORIA, OR",51248977,1171669,156802,"2013-12","2013"," OR","Astoria","41007","Clatsop",1538096,495662,652464,2709765,52787073,118,119,113,110,92,100
"73","2901","ASTORIA, OR",53490272,173506,115329,"2014-12","2014"," OR","Astoria","41007","Clatsop",3042768,183021,298350,3216274,56533040,118,119,113,110,92,100
"74","2901","ASTORIA, OR",47418585,1082487,396193,"2015-12","2015"," OR","Astoria","41007","Clatsop",3281815,58904,455097,4364302,50700400,118,119,113,110,92,100
"75","2901","ASTORIA, OR",37733429,72072,18232,"2016-12","2016"," OR","Astoria","41007","Clatsop",2495780,147933,166165,2567852,40229209,118,119,113,110,92,100
"76","2901","ASTORIA, OR",47934723,0,0,"2017-12","2017"," OR","Astoria","41007","Clatsop",367897,43775,43775,367897,48302620,118,119,113,110,92,100
"77","2901","ASTORIA, OR",32773078,49905,14964,"2018-12","2018"," OR","Astoria","41007","Clatsop",593154,168628,183592,643059,33366232,118,119,113,110,92,100
"78","2901","ASTORIA, OR",10337764,0,0,"2019-12","2019"," OR","Astoria","41007","Clatsop",439080,147332,147332,439080,10776844,118,119,113,110,92,100
"79","2901","ASTORIA, OR",558046,49940,9724,"2020-12","2020"," OR","Astoria","41007","Clatsop",1319877,256726,266450,1369817,1877923,118,119,113,110,92,100
"80","2901","ASTORIA, OR",1135227,170451,153177,"2021-12","2021"," OR","Astoria","41007","Clatsop",559755,85706,238883,730206,1694982,118,119,113,110,92,100
"81","1704","ATLANTA, GA",13308066507,0,0,"2013-12","2013"," GA","Atlanta","13067","Cobb",0,0,0,0,13308066507,23,172.5,168,168,170,170
"82","1704","ATLANTA, GA",14028323779,0,0,"2014-12","2014"," GA","Atlanta","13067","Cobb",0,0,0,0,14028323779,23,172.5,168,168,170,170
"83","1704","ATLANTA, GA",13868067477,0,0,"2015-12","2015"," GA","Atlanta","13067","Cobb",0,0,0,0,13868067477,23,172.5,168,168,170,170
"84","1704","ATLANTA, GA",15250754316,0,0,"2016-12","2016"," GA","Atlanta","13067","Cobb",0,0,0,0,15250754316,23,172.5,168,168,170,170
"85","1704","ATLANTA, GA",16733551702,0,0,"2017-12","2017"," GA","Atlanta","13067","Cobb",0,0,0,0,16733551702,23,172.5,168,168,170,170
"86","1704","ATLANTA, GA",20736563427,0,0,"2018-12","2018"," GA","Atlanta","13067","Cobb",0,0,0,0,20736563427,23,172.5,168,168,170,170
"87","1704","ATLANTA, GA",21861308391,0,0,"2019-12","2019"," GA","Atlanta","13067","Cobb",0,0,0,0,21861308391,23,172.5,168,168,170,170
"88","1704","ATLANTA, GA",15489752920,0,0,"2020-12","2020"," GA","Atlanta","13067","Cobb",0,0,0,0,15489752920,23,172.5,168,168,170,170
"89","1704","ATLANTA, GA",21625497217,0,0,"2021-12","2021"," GA","Atlanta","13067","Cobb",0,0,0,0,21625497217,23,172.5,168,168,170,170
"90","1303","BALTIMORE, MD",21021889347,4865561922,1503240969,"2013-12","2013"," MD","Baltimore","24005","Baltimore",15363653827,3664929350,5168170319,20229215749,36385543174,15,11,12,12,9,8
"91","1303","BALTIMORE, MD",18624613894,4771435564,1440932090,"2014-12","2014"," MD","Baltimore","24005","Baltimore",16264787393,4015688113,5456620203,21036222957,34889401287,15,11,12,12,9,8
"92","1303","BALTIMORE, MD",15373718236,4833056395,1439409270,"2015-12","2015"," MD","Baltimore","24005","Baltimore",16095327304,4535912555,5975321825,20928383699,31469045540,15,11,12,12,9,8
"93","1303","BALTIMORE, MD",14061033233,5863687845,1959517792,"2016-12","2016"," MD","Baltimore","24005","Baltimore",15322255747,4553174936,6512692728,21185943592,29383288980,15,11,12,12,9,8
"94","1303","BALTIMORE, MD",15863383108,5996752789,2282132191,"2017-12","2017"," MD","Baltimore","24005","Baltimore",17110705736,5128397125,7410529316,23107458525,32974088844,15,11,12,12,9,8
"95","1303","BALTIMORE, MD",16735659605,6558360568,2464501078,"2018-12","2018"," MD","Baltimore","24005","Baltimore",20606614449,5409441145,7873942223,27164975017,37342274054,15,11,12,12,9,8
"96","1303","BALTIMORE, MD",14933513169,5866693782,2749813248,"2019-12","2019"," MD","Baltimore","24005","Baltimore",21028392940,5410547598,8160360846,26895086722,35961906109,15,11,12,12,9,8
"97","1303","BALTIMORE, MD",12658174656,5645225977,2496097328,"2020-12","2020"," MD","Baltimore","24005","Baltimore",18264561504,5326086130,7822183458,23909787481,30922736160,15,11,12,12,9,8
"98","1303","BALTIMORE, MD",17040120979,7557588849,3317737831,"2021-12","2021"," MD","Baltimore","24005","Baltimore",20918115849,5805066886,9122804717,28475704698,37958236828,15,11,12,12,9,8
"99","0102","BANGOR, ME",664908051,313305,68307,"2013-12","2013"," ME","Bangor","23019","Penobscot",0,0,68307,313305,664908051,66,93,102,108,94,82
"100","0102","BANGOR, ME",1248936279,0,0,"2014-12","2014"," ME","Bangor","23019","Penobscot",6102633,33315121,33315121,6102633,1255038912,66,93,102,108,94,82
"101","0102","BANGOR, ME",942618887,590212,71334,"2015-12","2015"," ME","Bangor","23019","Penobscot",33581,9100,80434,623793,942652468,66,93,102,108,94,82
"102","0102","BANGOR, ME",1262776650,497610,490804,"2016-12","2016"," ME","Bangor","23019","Penobscot",34512,9609,500413,532122,1262811162,66,93,102,108,94,82
"103","0102","BANGOR, ME",927639188,724532,26449,"2017-12","2017"," ME","Bangor","23019","Penobscot",0,0,26449,724532,927639188,66,93,102,108,94,82
"104","0102","BANGOR, ME",907187542,387911,27301,"2018-12","2018"," ME","Bangor","23019","Penobscot",37696,47236,74537,425607,907225238,66,93,102,108,94,82
"105","0102","BANGOR, ME",1064356619,345391,24871,"2019-12","2019"," ME","Bangor","23019","Penobscot",30270,372,25243,375661,1064386889,66,93,102,108,94,82
"106","0102","BANGOR, ME",932120919,2144794,84289,"2020-12","2020"," ME","Bangor","23019","Penobscot",235736,30132,114421,2380530,932356655,66,93,102,108,94,82
"107","0102","BANGOR, ME",1491540179,441988,127994,"2021-12","2021"," ME","Bangor","23019","Penobscot",6081679,837632,965626,6523667,1497621858,66,93,102,108,94,82
"108","0112","BAR HARBOR, ME",873330,0,0,"2016-12","2016"," ME","Bar Harbor","23009","Hancock",0,0,0,0,873330,172,156,168,168,133,143
"109","0112","BAR HARBOR, ME",149747,0,0,"2019-12","2019"," ME","Bar Harbor","23009","Hancock",0,0,0,0,149747,172,156,168,168,133,143
"110","0112","BAR HARBOR, ME",1416762,0,0,"2021-12","2021"," ME","Bar Harbor","23009","Hancock",305571,9425,9425,305571,1722333,172,156,168,168,133,143
"111","0111","BATH, ME",2825,0,0,"2018-12","2018"," ME","Bath","23005","Cumberland",0,0,0,0,2825,185,172.5,168,168,170,170
"112","0111","BATH, ME",47592,0,0,"2019-12","2019"," ME","Bath","23005","Cumberland",0,0,0,0,47592,185,172.5,168,168,170,170
"113","2004","BATON ROUGE, LA",5046990529,12136819,27584620,"2013-12","2013"," LA","Baton Rouge","22121","West Baton Rouge",314232576,699071362,726655982,326369395,5361223105,32,30,54,33,43,28
"114","2004","BATON ROUGE, LA",6976264308,23797161,92333668,"2014-12","2014"," LA","Baton Rouge","22121","West Baton Rouge",395248131,529324590,621658258,419045292,7371512439,32,30,54,33,43,28
"115","2004","BATON ROUGE, LA",5320087490,34531073,147696930,"2015-12","2015"," LA","Baton Rouge","22121","West Baton Rouge",249967871,464906338,612603268,284498944,5570055361,32,30,54,33,43,28
"116","2004","BATON ROUGE, LA",5477205586,58561081,398719771,"2016-12","2016"," LA","Baton Rouge","22121","West Baton Rouge",69282930,378450844,777170615,127844011,5546488516,32,30,54,33,43,28
"117","2004","BATON ROUGE, LA",7562692558,90606462,380238797,"2017-12","2017"," LA","Baton Rouge","22121","West Baton Rouge",79612730,264722624,644961421,170219192,7642305288,32,30,54,33,43,28
"118","2004","BATON ROUGE, LA",8833326631,218932231,496056265,"2018-12","2018"," LA","Baton Rouge","22121","West Baton Rouge",80388636,277020980,773077245,299320867,8913715267,32,30,54,33,43,28
"119","2004","BATON ROUGE, LA",7460960888,114575698,326293073,"2019-12","2019"," LA","Baton Rouge","22121","West Baton Rouge",98177370,312081969,638375042,212753068,7559138258,32,30,54,33,43,28
"120","2004","BATON ROUGE, LA",6526925614,46180150,96105359,"2020-12","2020"," LA","Baton Rouge","22121","West Baton Rouge",70570191,495339574,591444933,116750341,6597495805,32,30,54,33,43,28
"121","2004","BATON ROUGE, LA",7537799458,16516072,32865075,"2021-12","2021"," LA","Baton Rouge","22121","West Baton Rouge",88090010,241009202,273874277,104606082,7625889468,32,30,54,33,43,28
"122","1511","BEAUFORT-MOREHEAD CITY, NC",371087732,563400,5101835,"2013-12","2013"," NC","Beaufort-Morehead Cty","37031","Carteret",311867276,129399246,134501081,312430676,682955008,82,54,104,86,42,47
"123","1511","BEAUFORT-MOREHEAD CITY, NC",231265881,439557,2108800,"2014-12","2014"," NC","Beaufort-Morehead Cty","37031","Carteret",235874216,137242223,139351023,236313773,467140097,82,54,104,86,42,47
"124","1511","BEAUFORT-MOREHEAD CITY, NC",265479620,56984,18601,"2015-12","2015"," NC","Beaufort-Morehead Cty","37031","Carteret",192643061,163304310,163322911,192700045,458122681,82,54,104,86,42,47
"125","1511","BEAUFORT-MOREHEAD CITY, NC",270293978,2105000,3029283,"2016-12","2016"," NC","Beaufort-Morehead Cty","37031","Carteret",187545537,118614013,121643296,189650537,457839515,82,54,104,86,42,47
"126","1511","BEAUFORT-MOREHEAD CITY, NC",259399881,319319,285424,"2017-12","2017"," NC","Beaufort-Morehead Cty","37031","Carteret",127134624,74154852,74440276,127453943,386534505,82,54,104,86,42,47
"127","1511","BEAUFORT-MOREHEAD CITY, NC",651005140,962373,25266,"2018-12","2018"," NC","Beaufort-Morehead Cty","37031","Carteret",179059016,142171615,142196881,180021389,830064156,82,54,104,86,42,47
"128","1511","BEAUFORT-MOREHEAD CITY, NC",377178622,417888,41336,"2019-12","2019"," NC","Beaufort-Morehead Cty","37031","Carteret",110719643,106282479,106323815,111137531,487898265,82,54,104,86,42,47
"129","1511","BEAUFORT-MOREHEAD CITY, NC",200609207,0,0,"2020-12","2020"," NC","Beaufort-Morehead Cty","37031","Carteret",79933981,60601966,60601966,79933981,280543188,82,54,104,86,42,47
"130","1511","BEAUFORT-MOREHEAD CITY, NC",151117146,20000,20000,"2021-12","2021"," NC","Beaufort-Morehead Cty","37031","Carteret",129576978,82640718,82660718,129596978,280694124,82,54,104,86,42,47
"131","2104","BEAUMONT, TX",6382386586,129330555,105715251,"2013-12","2013"," TX","Beaumont","48199","Hardin",352685522,532481385,638196636,482016077,6735072108,28,38,42,32,50,37
"132","2104","BEAUMONT, TX",6510040132,95315764,92496696,"2014-12","2014"," TX","Beaumont","48199","Hardin",228959318,320597688,413094384,324275082,6738999450,28,38,42,32,50,37
"133","2104","BEAUMONT, TX",5875750546,27674438,24551888,"2015-12","2015"," TX","Beaumont","48199","Hardin",139520586,324249300,348801188,167195024,6015271132,28,38,42,32,50,37
"134","2104","BEAUMONT, TX",5569460885,23268861,14516498,"2016-12","2016"," TX","Beaumont","48199","Hardin",97590142,158109602,172626100,120859003,5667051027,28,38,42,32,50,37
"135","2104","BEAUMONT, TX",11123310891,15566493,10371253,"2017-12","2017"," TX","Beaumont","48199","Hardin",50601906,136596254,146967507,66168399,11173912797,28,38,42,32,50,37
"136","2104","BEAUMONT, TX",16241962524,418718851,553213955,"2018-12","2018"," TX","Beaumont","48199","Hardin",41671416,134875384,688089339,460390267,16283633940,28,38,42,32,50,37
"137","2104","BEAUMONT, TX",19571865924,311050996,736725479,"2019-12","2019"," TX","Beaumont","48199","Hardin",23180153,62623385,799348864,334231149,19595046077,28,38,42,32,50,37
"138","2104","BEAUMONT, TX",9579676716,182182839,416169660,"2020-12","2020"," TX","Beaumont","48199","Hardin",5945083,21123149,437292809,188127922,9585621799,28,38,42,32,50,37
"139","2104","BEAUMONT, TX",16269497237,48490106,61536209,"2021-12","2021"," TX","Beaumont","48199","Hardin",41515405,35651617,97187826,90005511,16311012642,28,38,42,32,50,37
"140","0132","BELFAST, ME",181350,0,0,"2013-12","2013"," ME","Belfast","23027","Waldo",3960065,471025,471025,3960065,4141415,167,127,135,125,101,108
"141","0132","BELFAST, ME",50001,0,0,"2014-12","2014"," ME","Belfast","23027","Waldo",0,0,0,0,50001,167,127,135,125,101,108
"142","0132","BELFAST, ME",152541,50155,9890,"2015-12","2015"," ME","Belfast","23027","Waldo",0,0,9890,50155,152541,167,127,135,125,101,108
"143","0132","BELFAST, ME",613945,110091,112281,"2016-12","2016"," ME","Belfast","23027","Waldo",3118283,140000,252281,3228374,3732228,167,127,135,125,101,108
"144","0132","BELFAST, ME",958984,40695,11887,"2017-12","2017"," ME","Belfast","23027","Waldo",0,0,11887,40695,958984,167,127,135,125,101,108
"145","0132","BELFAST, ME",43842,0,0,"2018-12","2018"," ME","Belfast","23027","Waldo",0,0,0,0,43842,167,127,135,125,101,108
"146","0132","BELFAST, ME",81515,0,0,"2019-12","2019"," ME","Belfast","23027","Waldo",0,0,0,0,81515,167,127,135,125,101,108
"147","3005","BELLINGHAM, WA",517474796,5780187,2537934,"2013-12","2013"," WA","Bellingham","53073","Whatcom",1426668,103838,2641772,7206855,518901464,71,86,64,69,84,93
"148","3005","BELLINGHAM, WA",1000379767,56910918,23244510,"2014-12","2014"," WA","Bellingham","53073","Whatcom",1707498,699326,23943836,58618416,1002087265,71,86,64,69,84,93
"149","3005","BELLINGHAM, WA",496890801,28987160,11272214,"2015-12","2015"," WA","Bellingham","53073","Whatcom",442087,32388,11304602,29429247,497332888,71,86,64,69,84,93
"150","3005","BELLINGHAM, WA",397463885,44203069,18909174,"2016-12","2016"," WA","Bellingham","53073","Whatcom",1009332,523384,19432558,45212401,398473217,71,86,64,69,84,93
"151","3005","BELLINGHAM, WA",510327963,3348748,1510641,"2017-12","2017"," WA","Bellingham","53073","Whatcom",618039,171245,1681886,3966787,510946002,71,86,64,69,84,93
"152","3005","BELLINGHAM, WA",630458835,1430453,540635,"2018-12","2018"," WA","Bellingham","53073","Whatcom",491898,83339,623974,1922351,630950733,71,86,64,69,84,93
"153","3005","BELLINGHAM, WA",1026786611,1429441,504761,"2019-12","2019"," WA","Bellingham","53073","Whatcom",76788,36920,541681,1506229,1026863399,71,86,64,69,84,93
"154","3005","BELLINGHAM, WA",950700539,3567290,1805593,"2020-12","2020"," WA","Bellingham","53073","Whatcom",0,0,1805593,3567290,950700539,71,86,64,69,84,93
"155","3005","BELLINGHAM, WA",1277934323,4281152,2073919,"2021-12","2021"," WA","Bellingham","53073","Whatcom",31313182,4373140,6447059,35594334,1309247505,71,86,64,69,84,93
"156","1904","BIRMINGHAM, AL",11717905,0,0,"2013-12","2013"," AL","Birmingham","01073","Jefferson",0,0,0,0,11717905,111,172.5,168,168,170,170
"157","1904","BIRMINGHAM, AL",515125,0,0,"2014-12","2014"," AL","Birmingham","01073","Jefferson",0,0,0,0,515125,111,172.5,168,168,170,170
"158","1904","BIRMINGHAM, AL",2386434,0,0,"2015-12","2015"," AL","Birmingham","01073","Jefferson",0,0,0,0,2386434,111,172.5,168,168,170,170
"159","1904","BIRMINGHAM, AL",92716964,0,0,"2016-12","2016"," AL","Birmingham","01073","Jefferson",0,0,0,0,92716964,111,172.5,168,168,170,170
"160","1904","BIRMINGHAM, AL",229382903,0,0,"2017-12","2017"," AL","Birmingham","01073","Jefferson",0,0,0,0,229382903,111,172.5,168,168,170,170
"161","1904","BIRMINGHAM, AL",92385653,0,0,"2018-12","2018"," AL","Birmingham","01073","Jefferson",0,0,0,0,92385653,111,172.5,168,168,170,170
"162","1904","BIRMINGHAM, AL",12241081,0,0,"2019-12","2019"," AL","Birmingham","01073","Jefferson",0,0,0,0,12241081,111,172.5,168,168,170,170
"163","1904","BIRMINGHAM, AL",571164,0,0,"2020-12","2020"," AL","Birmingham","01073","Jefferson",0,0,0,0,571164,111,172.5,168,168,170,170
"164","1904","BIRMINGHAM, AL",256054,0,0,"2021-12","2021"," AL","Birmingham","01073","Jefferson",0,0,0,0,256054,111,172.5,168,168,170,170
"165","3004","BLAINE, WA",17348592191,64124074,14817877,"2013-12","2013"," WA","Blaine","53073","Whatcom",20878742,1154244,15972121,85002816,17369470933,24,79,55,64,73,89
"166","3004","BLAINE, WA",17313091193,62187914,13446251,"2014-12","2014"," WA","Blaine","53073","Whatcom",13498125,1028098,14474349,75686039,17326589318,24,79,55,64,73,89
"167","3004","BLAINE, WA",15443187859,63086827,16308681,"2015-12","2015"," WA","Blaine","53073","Whatcom",12891439,4539784,20848465,75978266,15456079298,24,79,55,64,73,89
"168","3004","BLAINE, WA",15321936510,64416361,14683800,"2016-12","2016"," WA","Blaine","53073","Whatcom",6594948,586667,15270467,71011309,15328531458,24,79,55,64,73,89
"169","3004","BLAINE, WA",15210341563,47882579,6054222,"2017-12","2017"," WA","Blaine","53073","Whatcom",7561067,720103,6774325,55443646,15217902630,24,79,55,64,73,89
"170","3004","BLAINE, WA",15233097405,70211376,7674853,"2018-12","2018"," WA","Blaine","53073","Whatcom",7397649,882121,8556974,77609025,15240495054,24,79,55,64,73,89
"171","3004","BLAINE, WA",14133468925,87216872,8272413,"2019-12","2019"," WA","Blaine","53073","Whatcom",11161125,1315849,9588262,98377997,14144630050,24,79,55,64,73,89
"172","3004","BLAINE, WA",12326376452,66876595,6412386,"2020-12","2020"," WA","Blaine","53073","Whatcom",4469513,358811,6771197,71346108,12330845965,24,79,55,64,73,89
"173","3004","BLAINE, WA",14253850005,63790577,7615133,"2021-12","2021"," WA","Blaine","53073","Whatcom",4779383,369245,7984378,68569960,14258629388,24,79,55,64,73,89
"174","0401","BOSTON, MA",1234937162,705342842,465363327,"2013-12","2013"," MA","Boston","25021","Norfolk",3629821406,833446259,1298809586,4335164248,4864758568,41,20,22,20,19,19
"175","0401","BOSTON, MA",1204183463,744893604,475205188,"2014-12","2014"," MA","Boston","25021","Norfolk",3798613914,1014453346,1489658534,4543507518,5002797377,41,20,22,20,19,19
"176","0401","BOSTON, MA",1014368039,630978459,488089008,"2015-12","2015"," MA","Boston","25021","Norfolk",4046975635,1111562254,1599651262,4677954094,5061343674,41,20,22,20,19,19
"177","0401","BOSTON, MA",1100351637,746927530,704225641,"2016-12","2016"," MA","Boston","25021","Norfolk",3936483274,990097582,1694323223,4683410804,5036834911,41,20,22,20,19,19
"178","0401","BOSTON, MA",1558383552,930560696,838785639,"2017-12","2017"," MA","Boston","25021","Norfolk",4142927199,1060404336,1899189975,5073487895,5701310751,41,20,22,20,19,19
"179","0401","BOSTON, MA",1264116793,962539228,833473644,"2018-12","2018"," MA","Boston","25021","Norfolk",4784002259,1126280386,1959754030,5746541487,6048119052,41,20,22,20,19,19
"180","0401","BOSTON, MA",1196275820,921646923,837513151,"2019-12","2019"," MA","Boston","25021","Norfolk",4846786564,1180745783,2018258934,5768433487,6043062384,41,20,22,20,19,19
"181","0401","BOSTON, MA",1070142769,818919129,887374025,"2020-12","2020"," MA","Boston","25021","Norfolk",4470790486,1085704556,1973078581,5289709615,5540933255,41,20,22,20,19,19
"182","0401","BOSTON, MA",1377776396,1031013790,758968426,"2021-12","2021"," MA","Boston","25021","Norfolk",3306822873,825703454,1584671880,4337836663,4684599269,41,20,22,20,19,19
"183","0410","BRIDGEPORT, CT",934367,21800,6589,"2013-12","2013"," CT","Bridgeport","09001","Fairfield",112821,21935,28524,134621,1047188,155,145,137,133,135,134
"184","0410","BRIDGEPORT, CT",3666268,25121,32770,"2014-12","2014"," CT","Bridgeport","09001","Fairfield",0,0,32770,25121,3666268,155,145,137,133,135,134
"185","0410","BRIDGEPORT, CT",1328324,102220,19927,"2015-12","2015"," CT","Bridgeport","09001","Fairfield",0,0,19927,102220,1328324,155,145,137,133,135,134
"186","0410","BRIDGEPORT, CT",7893079,0,0,"2016-12","2016"," CT","Bridgeport","09001","Fairfield",102106,21338,21338,102106,7995185,155,145,137,133,135,134
"187","0410","BRIDGEPORT, CT",14375254,24198,20026,"2017-12","2017"," CT","Bridgeport","09001","Fairfield",33462,11846,31872,57660,14408716,155,145,137,133,135,134
"188","0410","BRIDGEPORT, CT",3430991,15690,648,"2018-12","2018"," CT","Bridgeport","09001","Fairfield",500391,37631,38279,516081,3931382,155,145,137,133,135,134
"189","0410","BRIDGEPORT, CT",1701131,0,0,"2019-12","2019"," CT","Bridgeport","09001","Fairfield",33177,42330,42330,33177,1734308,155,145,137,133,135,134
"190","0410","BRIDGEPORT, CT",2742279,0,0,"2020-12","2020"," CT","Bridgeport","09001","Fairfield",21276,4785,4785,21276,2763555,155,145,137,133,135,134
"191","0410","BRIDGEPORT, CT",2253682,48361,3309,"2021-12","2021"," CT","Bridgeport","09001","Fairfield",0,0,3309,48361,2253682,155,145,137,133,135,134
"192","1701","BRUNSWICK, GA",5007920672,225042020,66505623,"2013-12","2013"," GA","Brunswick","13127","Glynn",805698567,82849535,149355158,1030740587,5813619239,36,52,32,45,29,52
"193","1701","BRUNSWICK, GA",5521895890,268925431,152574875,"2014-12","2014"," GA","Brunswick","13127","Glynn",382911618,26910396,179485271,651837049,5904807508,36,52,32,45,29,52
"194","1701","BRUNSWICK, GA",5867352948,116874506,113825442,"2015-12","2015"," GA","Brunswick","13127","Glynn",367522481,29895149,143720591,484396987,6234875429,36,52,32,45,29,52
"195","1701","BRUNSWICK, GA",6005673194,89797939,75565104,"2016-12","2016"," GA","Brunswick","13127","Glynn",349792962,26390018,101955122,439590901,6355466156,36,52,32,45,29,52
"196","1701","BRUNSWICK, GA",6021334986,306095074,46889526,"2017-12","2017"," GA","Brunswick","13127","Glynn",319588702,24641710,71531236,625683776,6340923688,36,52,32,45,29,52
"197","1701","BRUNSWICK, GA",5183923611,102640154,25754437,"2018-12","2018"," GA","Brunswick","13127","Glynn",582486851,42086854,67841291,685127005,5766410462,36,52,32,45,29,52
"198","1701","BRUNSWICK, GA",5663049297,64540446,20978894,"2019-12","2019"," GA","Brunswick","13127","Glynn",804114438,68766270,89745164,868654884,6467163735,36,52,32,45,29,52
"199","1701","BRUNSWICK, GA",7244331599,93343441,20775869,"2020-12","2020"," GA","Brunswick","13127","Glynn",1092319339,98780445,119556314,1185662780,8336650938,36,52,32,45,29,52
"200","1701","BRUNSWICK, GA",9101183024,1197665659,148229893,"2021-12","2021"," GA","Brunswick","13127","Glynn",1102986977,98676967,246906860,2300652636,10204170001,36,52,32,45,29,52
"201","0901","BUFFALO-NIAGARA FALLS, NY",44827244460,144670963,8047096,"2013-12","2013"," NY","Buffalo-Niagara Falls","36029","Erie",18566088,40870086,48917182,163237051,44845810548,13,64,33,55,55,64
"202","0901","BUFFALO-NIAGARA FALLS, NY",49398789039,142482709,16493404,"2014-12","2014"," NY","Buffalo-Niagara Falls","36029","Erie",59168730,23759598,40253002,201651439,49457957769,13,64,33,55,55,64
"203","0901","BUFFALO-NIAGARA FALLS, NY",47232009270,224916531,25750139,"2015-12","2015"," NY","Buffalo-Niagara Falls","36029","Erie",70443879,9732863,35483002,295360410,47302453149,13,64,33,55,55,64
"204","0901","BUFFALO-NIAGARA FALLS, NY",47173901525,234270665,42005037,"2016-12","2016"," NY","Buffalo-Niagara Falls","36029","Erie",77115000,14634336,56639373,311385665,47251016525,13,64,33,55,55,64
"205","0901","BUFFALO-NIAGARA FALLS, NY",42335080820,164639725,19248594,"2017-12","2017"," NY","Buffalo-Niagara Falls","36029","Erie",56717304,11712371,30960965,221357029,42391798124,13,64,33,55,55,64
"206","0901","BUFFALO-NIAGARA FALLS, NY",42302788222,241600209,23531009,"2018-12","2018"," NY","Buffalo-Niagara Falls","36029","Erie",63874614,14793741,38324750,305474823,42366662836,13,64,33,55,55,64
"207","0901","BUFFALO-NIAGARA FALLS, NY",41152557117,309525026,30623985,"2019-12","2019"," NY","Buffalo-Niagara Falls","36029","Erie",69447922,14532818,45156803,378972948,41222005039,13,64,33,55,55,64
"208","0901","BUFFALO-NIAGARA FALLS, NY",36796991968,377581306,22300513,"2020-12","2020"," NY","Buffalo-Niagara Falls","36029","Erie",52124135,13473500,35774013,429705441,36849116103,13,64,33,55,55,64
"209","0901","BUFFALO-NIAGARA FALLS, NY",42563483030,425212020,34392418,"2021-12","2021"," NY","Buffalo-Niagara Falls","36029","Erie",64708100,22074585,56467003,489920120,42628191130,13,64,33,55,55,64
"210","0115","CALAIS, ME",1524924625,7748024,2834293,"2013-12","2013"," ME","Calais","23029","Washington",0,0,2834293,7748024,1524924625,63,103,85,85,116,112
"211","0115","CALAIS, ME",1848522133,5817300,1760695,"2014-12","2014"," ME","Calais","23029","Washington",10032,2843,1763538,5827332,1848532165,63,103,85,85,116,112
"212","0115","CALAIS, ME",1260816017,1104896,323906,"2015-12","2015"," ME","Calais","23029","Washington",0,0,323906,1104896,1260816017,63,103,85,85,116,112
"213","0115","CALAIS, ME",1246226042,638152,192951,"2016-12","2016"," ME","Calais","23029","Washington",260366,12536,205487,898518,1246486408,63,103,85,85,116,112
"214","0115","CALAIS, ME",1304972896,975142,829655,"2017-12","2017"," ME","Calais","23029","Washington",0,0,829655,975142,1304972896,63,103,85,85,116,112
"215","0115","CALAIS, ME",1349415125,173481,76773,"2018-12","2018"," ME","Calais","23029","Washington",1492220,144312,221085,1665701,1350907345,63,103,85,85,116,112
"216","0115","CALAIS, ME",1281426629,387122,327480,"2019-12","2019"," ME","Calais","23029","Washington",302068,24858,352338,689190,1281728697,63,103,85,85,116,112
"217","0115","CALAIS, ME",1105929972,2917808,6423073,"2020-12","2020"," ME","Calais","23029","Washington",327445,190980,6614053,3245253,1106257417,63,103,85,85,116,112
"218","0115","CALAIS, ME",1581900096,1937240,2703200,"2021-12","2021"," ME","Calais","23029","Washington",167825,220500,2923700,2105065,1582067921,63,103,85,85,116,112
"219","1302","CAMBRIDGE, MD",5000,0,0,"2014-12","2014"," MD","Cambridge","24019","Dorchester",4759577,253057,253057,4759577,4764577,138,125,136,139,99,103
"220","1302","CAMBRIDGE, MD",50182,0,0,"2016-12","2016"," MD","Cambridge","24019","Dorchester",0,0,0,0,50182,138,125,136,139,99,103
"221","1302","CAMBRIDGE, MD",101351,0,0,"2017-12","2017"," MD","Cambridge","24019","Dorchester",18033,2606,2606,18033,119384,138,125,136,139,99,103
"222","1302","CAMBRIDGE, MD",83954,47414,8916,"2018-12","2018"," MD","Cambridge","24019","Dorchester",79740,9978,18894,127154,163694,138,125,136,139,99,103
"223","1302","CAMBRIDGE, MD",134901,98911,20770,"2019-12","2019"," MD","Cambridge","24019","Dorchester",2737331,353770,374540,2836242,2872232,138,125,136,139,99,103
"224","1302","CAMBRIDGE, MD",253279,42011,3857,"2020-12","2020"," MD","Cambridge","24019","Dorchester",90896,100544,104401,132907,344175,138,125,136,139,99,103
"225","1302","CAMBRIDGE, MD",79281642,0,0,"2021-12","2021"," MD","Cambridge","24019","Dorchester",634701,192371,192371,634701,79916343,138,125,136,139,99,103
"226","1107","CAMDEN, NJ",214838141,37651525,541016,"2013-12","2013"," NJ","Camden","42101","Philadelphia",3602382,2352251,2893267,41253907,218440523,102,82,57,82,77,75
"227","1107","CAMDEN, NJ",153273813,80255664,1382853,"2014-12","2014"," NJ","Camden","42101","Philadelphia",6914029,6797680,8180533,87169693,160187842,102,82,57,82,77,75
"228","1107","CAMDEN, NJ",69598673,1332450,1767185,"2015-12","2015"," NJ","Camden","42101","Philadelphia",23567846,32231752,33998937,24900296,93166519,102,82,57,82,77,75
"229","1107","CAMDEN, NJ",129361521,57909300,5380626,"2016-12","2016"," NJ","Camden","42101","Philadelphia",2113719,3034713,8415339,60023019,131475240,102,82,57,82,77,75
"230","1107","CAMDEN, NJ",26588859,10211523,1065722,"2017-12","2017"," NJ","Camden","42101","Philadelphia",2139462,290567,1356289,12350985,28728321,102,82,57,82,77,75
"231","0706","CAPE VINCENT, NY",2022277,0,0,"2013-12","2013"," NY","Cape Vincent","36045","Jefferson",0,0,0,0,2022277,165,159,168,168,149,149
"232","0706","CAPE VINCENT, NY",1053490,0,0,"2014-12","2014"," NY","Cape Vincent","36045","Jefferson",10023,2666,2666,10023,1063513,165,159,168,168,149,149
"233","2830","CARQUINEZ STRAIT, CA",32465153,0,0,"2013-12","2013"," CA","Carquinez Strait","06013","Contra Costa",0,0,0,0,32465153,91,84,77,104,47,76
"234","2830","CARQUINEZ STRAIT, CA",126586623,58575,213924,"2014-12","2014"," CA","Carquinez Strait","06013","Contra Costa",10143,1,213925,68718,126596766,91,84,77,104,47,76
"235","2830","CARQUINEZ STRAIT, CA",69098020,0,0,"2015-12","2015"," CA","Carquinez Strait","06013","Contra Costa",0,0,0,0,69098020,91,84,77,104,47,76
"236","2830","CARQUINEZ STRAIT, CA",165443542,19845916,976094,"2016-12","2016"," CA","Carquinez Strait","06013","Contra Costa",0,0,976094,19845916,165443542,91,84,77,104,47,76
"237","2830","CARQUINEZ STRAIT, CA",111610683,0,0,"2017-12","2017"," CA","Carquinez Strait","06013","Contra Costa",79490,2190,2190,79490,111690173,91,84,77,104,47,76
"238","2830","CARQUINEZ STRAIT, CA",75377483,12432643,580941,"2018-12","2018"," CA","Carquinez Strait","06013","Contra Costa",124916730,7733548,8314489,137349373,200294213,91,84,77,104,47,76
"239","2830","CARQUINEZ STRAIT, CA",26045012,466738,19857,"2019-12","2019"," CA","Carquinez Strait","06013","Contra Costa",152397608,10088434,10108291,152864346,178442620,91,84,77,104,47,76
"240","2830","CARQUINEZ STRAIT, CA",9120769,1220819,49213,"2020-12","2020"," CA","Carquinez Strait","06013","Contra Costa",344315536,21920411,21969624,345536355,353436305,91,84,77,104,47,76
"241","2830","CARQUINEZ STRAIT, CA",19919575,1355895,60031,"2021-12","2021"," CA","Carquinez Strait","06013","Contra Costa",555208791,34710951,34770982,556564686,575128366,91,84,77,104,47,76
"242","1601","CHARLESTON, SC",25903961147,13850270321,4648820081,"2013-12","2013"," SC","Charleston","45019","Charleston",37984729802,5251308723,9900128804,51835000123,63888690949,6,7,8,8,5,6
"243","1601","CHARLESTON, SC",30429905807,14594309681,5064092926,"2014-12","2014"," SC","Charleston","45019","Charleston",41918410664,6177163013,11241255939,56512720345,72348316471,6,7,8,8,5,6
"244","1601","CHARLESTON, SC",31630881399,15111060074,5456101978,"2015-12","2015"," SC","Charleston","45019","Charleston",45258135848,7129843211,12585945189,60369195922,76889017247,6,7,8,8,5,6
"245","1601","CHARLESTON, SC",33061344174,14427595777,5752722724,"2016-12","2016"," SC","Charleston","45019","Charleston",41872789603,7062522421,12815245145,56300385380,74934133777,6,7,8,8,5,6
"246","1601","CHARLESTON, SC",30920912949,15595715217,6607850886,"2017-12","2017"," SC","Charleston","45019","Charleston",42203518858,8283483910,14891334796,57799234075,73124431807,6,7,8,8,5,6
"247","1601","CHARLESTON, SC",34178141668,17963746184,7288296909,"2018-12","2018"," SC","Charleston","45019","Charleston",43448641149,7955987401,15244284310,61412387333,77626782817,6,7,8,8,5,6
"248","1601","CHARLESTON, SC",40077520226,17932506120,7003912511,"2019-12","2019"," SC","Charleston","45019","Charleston",44874527124,8146601292,15150513803,62807033244,84952047350,6,7,8,8,5,6
"249","1601","CHARLESTON, SC",30179500069,16633634095,6858244469,"2020-12","2020"," SC","Charleston","45019","Charleston",44259538281,8222215608,15080460077,60893172376,74439038350,6,7,8,8,5,6
"250","1601","CHARLESTON, SC",29826309792,18832303688,7245766514,"2021-12","2021"," SC","Charleston","45019","Charleston",55896046082,10153630115,17399396629,74728349770,85722355874,6,7,8,8,5,6
"251","1409","CHARLESTON, WV",138874,0,0,"2013-12","2013"," WV","Charleston","51813","Virginia Beach",0,0,0,0,138874,180,172.5,168,168,170,170
"252","1409","CHARLESTON, WV",822238,0,0,"2014-12","2014"," WV","Charleston","51813","Virginia Beach",0,0,0,0,822238,180,172.5,168,168,170,170
"253","1409","CHARLESTON, WV",12644,0,0,"2015-12","2015"," WV","Charleston","51813","Virginia Beach",0,0,0,0,12644,180,172.5,168,168,170,170
"254","1409","CHARLESTON, WV",397725,0,0,"2016-12","2016"," WV","Charleston","51813","Virginia Beach",0,0,0,0,397725,180,172.5,168,168,170,170
"255","1409","CHARLESTON, WV",263218,0,0,"2017-12","2017"," WV","Charleston","51813","Virginia Beach",0,0,0,0,263218,180,172.5,168,168,170,170
"256","1409","CHARLESTON, WV",1472380,0,0,"2018-12","2018"," WV","Charleston","51813","Virginia Beach",0,0,0,0,1472380,180,172.5,168,168,170,170
"257","1409","CHARLESTON, WV",235948,0,0,"2019-12","2019"," WV","Charleston","51813","Virginia Beach",0,0,0,0,235948,180,172.5,168,168,170,170
"258","1409","CHARLESTON, WV",252985,0,0,"2020-12","2020"," WV","Charleston","51813","Virginia Beach",0,0,0,0,252985,180,172.5,168,168,170,170
"259","1409","CHARLESTON, WV",8375,0,0,"2021-12","2021"," WV","Charleston","51813","Virginia Beach",0,0,0,0,8375,180,172.5,168,168,170,170
"260","1512","CHARLOTTE, NC",564303732,0,0,"2013-12","2013"," NC","Charlotte","45091","York",0,0,0,0,564303732,74,172.5,168,168,170,170
"261","1512","CHARLOTTE, NC",630167462,0,0,"2014-12","2014"," NC","Charlotte","45091","York",0,0,0,0,630167462,74,172.5,168,168,170,170
"262","1512","CHARLOTTE, NC",760762209,0,0,"2015-12","2015"," NC","Charlotte","45091","York",0,0,0,0,760762209,74,172.5,168,168,170,170
"263","1512","CHARLOTTE, NC",613995957,0,0,"2016-12","2016"," NC","Charlotte","45091","York",0,0,0,0,613995957,74,172.5,168,168,170,170
"264","1512","CHARLOTTE, NC",843717290,0,0,"2017-12","2017"," NC","Charlotte","45091","York",0,0,0,0,843717290,74,172.5,168,168,170,170
"265","1512","CHARLOTTE, NC",944932427,0,0,"2018-12","2018"," NC","Charlotte","45091","York",0,0,0,0,944932427,74,172.5,168,168,170,170
"266","1512","CHARLOTTE, NC",801956715,0,0,"2019-12","2019"," NC","Charlotte","45091","York",0,0,0,0,801956715,74,172.5,168,168,170,170
"267","1512","CHARLOTTE, NC",273015307,0,0,"2020-12","2020"," NC","Charlotte","45091","York",0,0,0,0,273015307,74,172.5,168,168,170,170
"268","1512","CHARLOTTE, NC",392558288,0,0,"2021-12","2021"," NC","Charlotte","45091","York",0,0,0,0,392558288,74,172.5,168,168,170,170
"269","1102","CHESTER, PA",1941869724,1700803694,333316158,"2013-12","2013"," PA","Chester","42045","Delaware",3471301736,721597558,1054913716,5172105430,5413171460,33,23,19,31,18,22
"270","1102","CHESTER, PA",2049420075,1811924950,338351920,"2014-12","2014"," PA","Chester","42045","Delaware",3320990420,669207976,1007559896,5132915370,5370410495,33,23,19,31,18,22
"271","1102","CHESTER, PA",1927112459,1628887336,259079693,"2015-12","2015"," PA","Chester","42045","Delaware",3415993488,608245810,867325503,5044880824,5343105947,33,23,19,31,18,22
"272","1102","CHESTER, PA",2125337031,1733769244,224560449,"2016-12","2016"," PA","Chester","42045","Delaware",3441135042,687586505,912146954,5174904286,5566472073,33,23,19,31,18,22
"273","1102","CHESTER, PA",2204832853,1900025045,225309273,"2017-12","2017"," PA","Chester","42045","Delaware",3931986055,810221836,1035531109,5832011100,6136818908,33,23,19,31,18,22
"274","1102","CHESTER, PA",2785689737,2070016971,252481427,"2018-12","2018"," PA","Chester","42045","Delaware",4381287966,772722983,1025204410,6451304937,7166977703,33,23,19,31,18,22
"275","1102","CHESTER, PA",3390945419,2188742501,223820305,"2019-12","2019"," PA","Chester","42045","Delaware",4765743993,879338432,1103158737,6954486494,8156689412,33,23,19,31,18,22
"276","1102","CHESTER, PA",2766368039,1630508039,173741184,"2020-12","2020"," PA","Chester","42045","Delaware",4722523733,896472414,1070213598,6353031772,7488891772,33,23,19,31,18,22
"277","1102","CHESTER, PA",4282458877,2335114868,270115254,"2021-12","2021"," PA","Chester","42045","Delaware",7084235852,1066835637,1336950891,9419350720,11366694729,33,23,19,31,18,22
"278","3901","CHICAGO, IL",40015838173,68480057,40155933,"2013-12","2013"," IL","Chicago","17043","DuPage",457747906,89060211,129216144,526227963,40473586079,9,45,40,47,34,38
"279","3901","CHICAGO, IL",44078446314,104290956,36225563,"2014-12","2014"," IL","Chicago","17043","DuPage",610247281,240889723,277115286,714538237,44688693595,9,45,40,47,34,38
"280","3901","CHICAGO, IL",46405933514,115747436,36116740,"2015-12","2015"," IL","Chicago","17043","DuPage",581692189,273414847,309531587,697439625,46987625703,9,45,40,47,34,38
"281","3901","CHICAGO, IL",45482334664,148981370,77829870,"2016-12","2016"," IL","Chicago","17043","DuPage",419591797,241049953,318879823,568573167,45901926461,9,45,40,47,34,38
"282","3901","CHICAGO, IL",47829897517,141179465,40140764,"2017-12","2017"," IL","Chicago","17043","DuPage",540894116,164646892,204787656,682073581,48370791633,9,45,40,47,34,38
"283","3901","CHICAGO, IL",52236390692,213734472,59542468,"2018-12","2018"," IL","Chicago","17043","DuPage",649419874,142165553,201708021,863154346,52885810566,9,45,40,47,34,38
"284","3901","CHICAGO, IL",50398648221,260171237,93995979,"2019-12","2019"," IL","Chicago","17043","DuPage",312176618,107627759,201623738,572347855,50710824839,9,45,40,47,34,38
"285","3901","CHICAGO, IL",53419493804,175692636,91246076,"2020-12","2020"," IL","Chicago","17043","DuPage",275119597,187349557,278595633,450812233,53694613401,9,45,40,47,34,38
"286","3901","CHICAGO, IL",64556679366,253566503,102293833,"2021-12","2021"," IL","Chicago","17043","DuPage",360505943,67536814,169830647,614072446,64917185309,9,45,40,47,34,38
"287","4102","CINCINNATI-LAWRENCEBURG, OH",4205275434,0,0,"2013-12","2013"," OH","Cincinnati","39061","Hamilton",0,0,0,0,4205275434,40,172.5,168,168,170,170
"288","4102","CINCINNATI-LAWRENCEBURG, OH",4382457294,0,0,"2014-12","2014"," OH","Cincinnati","39061","Hamilton",0,0,0,0,4382457294,40,172.5,168,168,170,170
"289","4102","CINCINNATI-LAWRENCEBURG, OH",5401835284,0,0,"2015-12","2015"," OH","Cincinnati","39061","Hamilton",0,0,0,0,5401835284,40,172.5,168,168,170,170
"290","4102","CINCINNATI-LAWRENCEBURG, OH",5096248140,0,0,"2016-12","2016"," OH","Cincinnati","39061","Hamilton",0,0,0,0,5096248140,40,172.5,168,168,170,170
"291","4102","CINCINNATI-LAWRENCEBURG, OH",5271200229,0,0,"2017-12","2017"," OH","Cincinnati","39061","Hamilton",0,0,0,0,5271200229,40,172.5,168,168,170,170
"292","4102","CINCINNATI-LAWRENCEBURG, OH",6590473033,0,0,"2018-12","2018"," OH","Cincinnati","39061","Hamilton",0,0,0,0,6590473033,40,172.5,168,168,170,170
"293","4102","CINCINNATI-LAWRENCEBURG, OH",7356004266,0,0,"2019-12","2019"," OH","Cincinnati","39061","Hamilton",0,0,0,0,7356004266,40,172.5,168,168,170,170
"294","4102","CINCINNATI-LAWRENCEBURG, OH",5117223557,0,0,"2020-12","2020"," OH","Cincinnati","39061","Hamilton",0,0,0,0,5117223557,40,172.5,168,168,170,170
"295","4102","CINCINNATI-LAWRENCEBURG, OH",4666515482,0,0,"2021-12","2021"," OH","Cincinnati","39061","Hamilton",0,0,0,0,4666515482,40,172.5,168,168,170,170
"296","0714","CLAYTON, NY",994165,0,0,"2013-12","2013"," NY","Clayton","36045","Jefferson",19859,4332,4332,19859,1014024,166,153,142,143,150,148
"297","0714","CLAYTON, NY",1698573,0,0,"2014-12","2014"," NY","Clayton","36045","Jefferson",0,0,0,0,1698573,166,153,142,143,150,148
"298","0714","CLAYTON, NY",1923744,0,0,"2016-12","2016"," NY","Clayton","36045","Jefferson",0,0,0,0,1923744,166,153,142,143,150,148
"299","0714","CLAYTON, NY",1079805,0,0,"2017-12","2017"," NY","Clayton","36045","Jefferson",0,0,0,0,1079805,166,153,142,143,150,148
"300","0714","CLAYTON, NY",1422502,36764,14996,"2018-12","2018"," NY","Clayton","36045","Jefferson",0,0,14996,36764,1422502,166,153,142,143,150,148
"301","0714","CLAYTON, NY",1297729,28000,8181,"2021-12","2021"," NY","Clayton","36045","Jefferson",8714,4372,12553,36714,1306443,166,153,142,143,150,148
"302","4101","CLEVELAND, OH",26237371973,10710572,2609695,"2013-12","2013"," OH","Cleveland","39035","Cuyahoga",17731526,3039205,5648900,28442098,26255103499,16,61,59,68,45,53
"303","4101","CLEVELAND, OH",26212375134,68775107,9194280,"2014-12","2014"," OH","Cleveland","39035","Cuyahoga",42198656,60415804,69610084,110973763,26254573790,16,61,59,68,45,53
"304","4101","CLEVELAND, OH",25973803062,41424717,10207420,"2015-12","2015"," OH","Cleveland","39035","Cuyahoga",123152387,30749865,40957285,164577104,26096955449,16,61,59,68,45,53
"305","4101","CLEVELAND, OH",28726492356,29134462,9845824,"2016-12","2016"," OH","Cleveland","39035","Cuyahoga",156899244,70157287,80003111,186033706,28883391600,16,61,59,68,45,53
"306","4101","CLEVELAND, OH",32888309718,12527261,4433003,"2017-12","2017"," OH","Cleveland","39035","Cuyahoga",247045354,25556556,29989559,259572615,33135355072,16,61,59,68,45,53
"307","4101","CLEVELAND, OH",36499535360,25826249,7646864,"2018-12","2018"," OH","Cleveland","39035","Cuyahoga",146038057,57083426,64730290,171864306,36645573417,16,61,59,68,45,53
"308","4101","CLEVELAND, OH",41088424416,22090939,6459824,"2019-12","2019"," OH","Cleveland","39035","Cuyahoga",141868868,88414529,94874353,163959807,41230293284,16,61,59,68,45,53
"309","4101","CLEVELAND, OH",40044113447,14577364,5515738,"2020-12","2020"," OH","Cleveland","39035","Cuyahoga",136654433,65354184,70869922,151231797,40180767880,16,61,59,68,45,53
"310","4101","CLEVELAND, OH",43641098223,29453554,6632169,"2021-12","2021"," OH","Cleveland","39035","Cuyahoga",210471852,48798133,55430302,239925406,43851570075,16,61,59,68,45,53
"311","1604","COLUMBIA, SC",347334,0,0,"2013-12","2013"," SC","Columbia","45079","Richland",0,0,0,0,347334,168,172.5,168,168,170,170
"312","1604","COLUMBIA, SC",1476614,0,0,"2014-12","2014"," SC","Columbia","45079","Richland",0,0,0,0,1476614,168,172.5,168,168,170,170
"313","1604","COLUMBIA, SC",3572440,0,0,"2015-12","2015"," SC","Columbia","45079","Richland",0,0,0,0,3572440,168,172.5,168,168,170,170
"314","1604","COLUMBIA, SC",2884685,0,0,"2016-12","2016"," SC","Columbia","45079","Richland",0,0,0,0,2884685,168,172.5,168,168,170,170
"315","1604","COLUMBIA, SC",167491,0,0,"2017-12","2017"," SC","Columbia","45079","Richland",0,0,0,0,167491,168,172.5,168,168,170,170
"316","1604","COLUMBIA, SC",571026,0,0,"2018-12","2018"," SC","Columbia","45079","Richland",0,0,0,0,571026,168,172.5,168,168,170,170
"317","1604","COLUMBIA, SC",1512901,0,0,"2019-12","2019"," SC","Columbia","45079","Richland",0,0,0,0,1512901,168,172.5,168,168,170,170
"318","1604","COLUMBIA, SC",12477,0,0,"2020-12","2020"," SC","Columbia","45079","Richland",0,0,0,0,12477,168,172.5,168,168,170,170
"319","1604","COLUMBIA, SC",855960,0,0,"2021-12","2021"," SC","Columbia","45079","Richland",0,0,0,0,855960,168,172.5,168,168,170,170
"320","4103","COLUMBUS, OH",32951617,0,0,"2013-12","2013"," OH","Columbus","39045","Fairfield",0,0,0,0,32951617,84,172.5,168,168,170,170
"321","4103","COLUMBUS, OH",239336098,0,0,"2014-12","2014"," OH","Columbus","39045","Fairfield",0,0,0,0,239336098,84,172.5,168,168,170,170
"322","4103","COLUMBUS, OH",167635690,0,0,"2015-12","2015"," OH","Columbus","39045","Fairfield",0,0,0,0,167635690,84,172.5,168,168,170,170
"323","4103","COLUMBUS, OH",163657547,0,0,"2016-12","2016"," OH","Columbus","39045","Fairfield",0,0,0,0,163657547,84,172.5,168,168,170,170
"324","4103","COLUMBUS, OH",531548465,0,0,"2017-12","2017"," OH","Columbus","39045","Fairfield",0,0,0,0,531548465,84,172.5,168,168,170,170
"325","4103","COLUMBUS, OH",911991736,0,0,"2018-12","2018"," OH","Columbus","39045","Fairfield",0,0,0,0,911991736,84,172.5,168,168,170,170
"326","4103","COLUMBUS, OH",729749181,0,0,"2019-12","2019"," OH","Columbus","39045","Fairfield",0,0,0,0,729749181,84,172.5,168,168,170,170
"327","4103","COLUMBUS, OH",549781851,0,0,"2020-12","2020"," OH","Columbus","39045","Fairfield",0,0,0,0,549781851,84,172.5,168,168,170,170
"328","4103","COLUMBUS, OH",808643069,0,0,"2021-12","2021"," OH","Columbus","39045","Fairfield",0,0,0,0,808643069,84,172.5,168,168,170,170
"329","2903","COOS BAY, OR",170406096,2449760,38062436,"2013-12","2013"," OR","Coos Bay","41011","Coos",0,0,38062436,2449760,170406096,96,87,116,74,126,86
"330","2903","COOS BAY, OR",139974390,0,0,"2014-12","2014"," OR","Coos Bay","41011","Coos",0,0,0,0,139974390,96,87,116,74,126,86
"331","2903","COOS BAY, OR",131153511,0,0,"2015-12","2015"," OR","Coos Bay","41011","Coos",0,0,0,0,131153511,96,87,116,74,126,86
"332","2903","COOS BAY, OR",142797119,0,0,"2016-12","2016"," OR","Coos Bay","41011","Coos",177517,8039,8039,177517,142974636,96,87,116,74,126,86
"333","2903","COOS BAY, OR",137350884,0,0,"2017-12","2017"," OR","Coos Bay","41011","Coos",1196348,16772188,16772188,1196348,138547232,96,87,116,74,126,86
"334","2903","COOS BAY, OR",188113150,0,0,"2018-12","2018"," OR","Coos Bay","41011","Coos",71205,16705,16705,71205,188184355,96,87,116,74,126,86
"335","2903","COOS BAY, OR",163651409,0,0,"2019-12","2019"," OR","Coos Bay","41011","Coos",38178,1155,1155,38178,163689587,96,87,116,74,126,86
"336","2903","COOS BAY, OR",116591199,0,0,"2020-12","2020"," OR","Coos Bay","41011","Coos",0,0,0,0,116591199,96,87,116,74,126,86
"337","2903","COOS BAY, OR",177477399,0,0,"2021-12","2021"," OR","Coos Bay","41011","Coos",33830,3453,3453,33830,177511229,96,87,116,74,126,86
"338","5312","CORPUS CHRISTI, TX",10437823605,799385585,1387906207,"2013-12","2013"," TX","Corpus Christi","48409","San Patricio",377944088,108478366,1496384573,1177329673,10815767693,19,24,27,18,39,39
"339","5312","CORPUS CHRISTI, TX",12087979101,973878067,1717124216,"2014-12","2014"," TX","Corpus Christi","48409","San Patricio",101805472,34229328,1751353544,1075683539,12189784573,19,24,27,18,39,39
"340","5312","CORPUS CHRISTI, TX",9923075714,570248700,1396710839,"2015-12","2015"," TX","Corpus Christi","48409","San Patricio",212358940,65314218,1462025057,782607640,10135434654,19,24,27,18,39,39
"341","5312","CORPUS CHRISTI, TX",9793957848,234375762,593723293,"2016-12","2016"," TX","Corpus Christi","48409","San Patricio",448492513,313440288,907163581,682868275,10242450361,19,24,27,18,39,39
"342","5312","CORPUS CHRISTI, TX",15780975024,14109418,2726466,"2017-12","2017"," TX","Corpus Christi","48409","San Patricio",702950361,292056841,294783307,717059779,16483925385,19,24,27,18,39,39
"343","5312","CORPUS CHRISTI, TX",23256776031,74370156,109140811,"2018-12","2018"," TX","Corpus Christi","48409","San Patricio",104949875,154790439,263931250,179320031,23361725906,19,24,27,18,39,39
"344","5312","CORPUS CHRISTI, TX",28635953611,148833043,693518435,"2019-12","2019"," TX","Corpus Christi","48409","San Patricio",57059634,263353845,956872280,205892677,28693013245,19,24,27,18,39,39
"345","5312","CORPUS CHRISTI, TX",31637090027,178131898,999742021,"2020-12","2020"," TX","Corpus Christi","48409","San Patricio",86703687,42953571,1042695592,264835585,31723793714,19,24,27,18,39,39
"346","5312","CORPUS CHRISTI, TX",51471448990,361048468,967567054,"2021-12","2021"," TX","Corpus Christi","48409","San Patricio",60837141,96165915,1063732969,421885609,51532286131,19,24,27,18,39,39
"347","2815","CROCKETT, CA",108190,108190,21120,"2014-12","2014"," CA","Crockett","06013","Contra Costa",4072052,9446530,9467650,4180242,4180242,151,75,126,126,80,70
"348","2815","CROCKETT, CA",1088728,0,0,"2015-12","2015"," CA","Crockett","06013","Contra Costa",22977296,45840000,45840000,22977296,24066024,151,75,126,126,80,70
"349","2815","CROCKETT, CA",18983,18983,901,"2017-12","2017"," CA","Crockett","06013","Contra Costa",0,0,901,18983,18983,151,75,126,126,80,70
"350","2815","CROCKETT, CA",177660,160650,50337,"2019-12","2019"," CA","Crockett","06013","Contra Costa",0,0,50337,160650,177660,151,75,126,126,80,70
"351","2815","CROCKETT, CA",25109,25109,19090,"2021-12","2021"," CA","Crockett","06013","Contra Costa",5869126,9980000,9999090,5894235,5894235,151,75,126,126,80,70
"352","4104","DAYTON, OH",12672801,0,0,"2013-12","2013"," OH","Dayton","39113","Montgomery",0,0,0,0,12672801,128,172.5,168,168,170,170
"353","4104","DAYTON, OH",33987615,0,0,"2014-12","2014"," OH","Dayton","39113","Montgomery",0,0,0,0,33987615,128,172.5,168,168,170,170
"354","4104","DAYTON, OH",13341456,0,0,"2015-12","2015"," OH","Dayton","39113","Montgomery",0,0,0,0,13341456,128,172.5,168,168,170,170
"355","4104","DAYTON, OH",16015713,0,0,"2016-12","2016"," OH","Dayton","39113","Montgomery",0,0,0,0,16015713,128,172.5,168,168,170,170
"356","4104","DAYTON, OH",15366045,0,0,"2017-12","2017"," OH","Dayton","39113","Montgomery",0,0,0,0,15366045,128,172.5,168,168,170,170
"357","4104","DAYTON, OH",38017274,0,0,"2018-12","2018"," OH","Dayton","39113","Montgomery",0,0,0,0,38017274,128,172.5,168,168,170,170
"358","4104","DAYTON, OH",33165723,0,0,"2019-12","2019"," OH","Dayton","39113","Montgomery",0,0,0,0,33165723,128,172.5,168,168,170,170
"359","4104","DAYTON, OH",13216700,0,0,"2020-12","2020"," OH","Dayton","39113","Montgomery",0,0,0,0,13216700,128,172.5,168,168,170,170
"360","4104","DAYTON, OH",16765132,0,0,"2021-12","2021"," OH","Dayton","39113","Montgomery",0,0,0,0,16765132,128,172.5,168,168,170,170
"361","3801","DETROIT, MI",81546251780,714187891,140828212,"2013-12","2013"," MI","Detroit","26125","Oakland",239778546,127865557,268693769,953966437,81786030326,5,55,37,51,48,49
"362","3801","DETROIT, MI",80653125114,324896903,50360650,"2014-12","2014"," MI","Detroit","26125","Oakland",113076256,21563178,71923828,437973159,80766201370,5,55,37,51,48,49
"363","3801","DETROIT, MI",74419652342,123722641,22743676,"2015-12","2015"," MI","Detroit","26125","Oakland",110426613,24753413,47497089,234149254,74530078955,5,55,37,51,48,49
"364","3801","DETROIT, MI",73250513583,102588350,26884904,"2016-12","2016"," MI","Detroit","26125","Oakland",60163009,69261387,96146291,162751359,73310676592,5,55,37,51,48,49
"365","3801","DETROIT, MI",78306028883,124756500,40010948,"2017-12","2017"," MI","Detroit","26125","Oakland",91949326,17204194,57215142,216705826,78397978209,5,55,37,51,48,49
"366","3801","DETROIT, MI",78866862555,68325971,19785432,"2018-12","2018"," MI","Detroit","26125","Oakland",61252212,71027740,90813172,129578183,78928114767,5,55,37,51,48,49
"367","3801","DETROIT, MI",79428498888,90261488,25408132,"2019-12","2019"," MI","Detroit","26125","Oakland",117692877,64256524,89664656,207954365,79546191765,5,55,37,51,48,49
"368","3801","DETROIT, MI",68784299092,88926785,21138297,"2020-12","2020"," MI","Detroit","26125","Oakland",116526157,71048242,92186539,205452942,68900825249,5,55,37,51,48,49
"369","3801","DETROIT, MI",76717187331,105436333,25027865,"2021-12","2021"," MI","Detroit","26125","Oakland",157363781,94478646,119506511,262800114,76874551112,5,55,37,51,48,49
"370","3510","DULUTH, MN - SUPERIOR, WI",498765244,1976155,281151,"2013-12","2013"," WI","Duluth","55031","Douglas",14334270,19603784,19884935,16310425,513099514,79,72,91,84,56,63
"371","3510","DULUTH, MN - SUPERIOR, WI",450741845,0,0,"2014-12","2014"," WI","Duluth","55031","Douglas",44719662,3216833,3216833,44719662,495461507,79,72,91,84,56,63
"372","3510","DULUTH, MN - SUPERIOR, WI",403649770,1419365,197425,"2015-12","2015"," WI","Duluth","55031","Douglas",99348524,15308689,15506114,100767889,502998294,79,72,91,84,56,63
"373","3510","DULUTH, MN - SUPERIOR, WI",363435197,69240,114223,"2016-12","2016"," WI","Duluth","55031","Douglas",62175757,5612860,5727083,62244997,425610954,79,72,91,84,56,63
"374","3510","DULUTH, MN - SUPERIOR, WI",453708126,3484473,12758340,"2017-12","2017"," WI","Duluth","55031","Douglas",69198863,14247000,27005340,72683336,522906989,79,72,91,84,56,63
"375","3510","DULUTH, MN - SUPERIOR, WI",458296003,1425732,535420,"2018-12","2018"," WI","Duluth","55031","Douglas",99272285,6563152,7098572,100698017,557568288,79,72,91,84,56,63
"376","3510","DULUTH, MN - SUPERIOR, WI",531456252,312653,428990,"2019-12","2019"," WI","Duluth","55031","Douglas",25009701,31205275,31634265,25322354,556465953,79,72,91,84,56,63
"377","3510","DULUTH, MN - SUPERIOR, WI",387347455,1171787,288591,"2020-12","2020"," WI","Duluth","55031","Douglas",40931135,32498129,32786720,42102922,428278590,79,72,91,84,56,63
"378","3510","DULUTH, MN - SUPERIOR, WI",434772441,2148521,1194089,"2021-12","2021"," WI","Duluth","55031","Douglas",69413266,55202925,56397014,71561787,504185707,79,72,91,84,56,63
"379","1503","DURHAM, NC",639352491,0,0,"2013-12","2013"," NC","Durham","37183","Wake",0,0,0,0,639352491,86,172.5,168,168,170,170
"380","1503","DURHAM, NC",584100086,0,0,"2014-12","2014"," NC","Durham","37183","Wake",0,0,0,0,584100086,86,172.5,168,168,170,170
"381","1503","DURHAM, NC",294993367,0,0,"2015-12","2015"," NC","Durham","37183","Wake",0,0,0,0,294993367,86,172.5,168,168,170,170
"382","1503","DURHAM, NC",341218111,0,0,"2016-12","2016"," NC","Durham","37183","Wake",0,0,0,0,341218111,86,172.5,168,168,170,170
"383","1503","DURHAM, NC",435392599,0,0,"2017-12","2017"," NC","Durham","37183","Wake",0,0,0,0,435392599,86,172.5,168,168,170,170
"384","1503","DURHAM, NC",561602233,0,0,"2018-12","2018"," NC","Durham","37183","Wake",0,0,0,0,561602233,86,172.5,168,168,170,170
"385","1503","DURHAM, NC",318249517,0,0,"2019-12","2019"," NC","Durham","37183","Wake",0,0,0,0,318249517,86,172.5,168,168,170,170
"386","1503","DURHAM, NC",65277708,0,0,"2020-12","2020"," NC","Durham","37183","Wake",0,0,0,0,65277708,86,172.5,168,168,170,170
"387","1503","DURHAM, NC",35552607,0,0,"2021-12","2021"," NC","Durham","37183","Wake",0,0,0,0,35552607,86,172.5,168,168,170,170
"388","0103","EASTPORT, ME",288506100,43575297,71112116,"2013-12","2013"," ME","Eastport","23029","Washington",67827,78600,71190716,43643124,288573927,95,70,67,54,138,122
"389","0103","EASTPORT, ME",154003017,216630,390026,"2014-12","2014"," ME","Eastport","23029","Washington",0,0,390026,216630,154003017,95,70,67,54,138,122
"390","0103","EASTPORT, ME",184576245,7323220,15317832,"2015-12","2015"," ME","Eastport","23029","Washington",197394,26143,15343975,7520614,184773639,95,70,67,54,138,122
"391","0103","EASTPORT, ME",133328382,4060,42,"2016-12","2016"," ME","Eastport","23029","Washington",152162,175200,175242,156222,133480544,95,70,67,54,138,122
"392","0103","EASTPORT, ME",114778146,518418,23802,"2017-12","2017"," ME","Eastport","23029","Washington",0,0,23802,518418,114778146,95,70,67,54,138,122
"393","0103","EASTPORT, ME",208773644,44701293,75056305,"2018-12","2018"," ME","Eastport","23029","Washington",0,0,75056305,44701293,208773644,95,70,67,54,138,122
"394","0103","EASTPORT, ME",143639316,38297193,62517118,"2019-12","2019"," ME","Eastport","23029","Washington",78526,9936,62527054,38375719,143717842,95,70,67,54,138,122
"395","0103","EASTPORT, ME",80740113,4044,2539,"2020-12","2020"," ME","Eastport","23029","Washington",39285,19262,21801,43329,80779398,95,70,67,54,138,122
"396","0103","EASTPORT, ME",88753195,0,0,"2021-12","2021"," ME","Eastport","23029","Washington",129897,27178,27178,129897,88883092,95,70,67,54,138,122
"397","4106","ERIE, PA",861816,54845,13165,"2013-12","2013"," PA","Erie","42049","Erie",606658,165100,178265,661503,1468474,129,106,127,142,76,91
"398","4106","ERIE, PA",54453025,480397,26412,"2014-12","2014"," PA","Erie","42049","Erie",8644752,1158501,1184913,9125149,63097777,129,106,127,142,76,91
"399","4106","ERIE, PA",23784714,0,0,"2015-12","2015"," PA","Erie","42049","Erie",885550,139337,139337,885550,24670264,129,106,127,142,76,91
"400","4106","ERIE, PA",89606,0,0,"2016-12","2016"," PA","Erie","42049","Erie",16112211,2056327,2056327,16112211,16201817,129,106,127,142,76,91
"401","4106","ERIE, PA",4980811,0,0,"2017-12","2017"," PA","Erie","42049","Erie",4081534,530006,530006,4081534,9062345,129,106,127,142,76,91
"402","4106","ERIE, PA",2854973,0,0,"2018-12","2018"," PA","Erie","42049","Erie",4194452,1231000,1231000,4194452,7049425,129,106,127,142,76,91
"403","4106","ERIE, PA",15225138,0,0,"2019-12","2019"," PA","Erie","42049","Erie",4295331,567441,567441,4295331,19520469,129,106,127,142,76,91
"404","4106","ERIE, PA",1758979,0,0,"2020-12","2020"," PA","Erie","42049","Erie",5589981,511092,511092,5589981,7348960,129,106,127,142,76,91
"405","4106","ERIE, PA",1990073,0,0,"2021-12","2021"," PA","Erie","42049","Erie",25661030,1454129,1454129,25661030,27651103,129,106,127,142,76,91
"406","3808","ESCANABA, MI",1658044,0,0,"2013-12","2013"," MI","Escanaba","26041","Delta",129222,17438,17438,129222,1787266,162,142,144,148,122,124
"407","3808","ESCANABA, MI",1559711,0,0,"2014-12","2014"," MI","Escanaba","26041","Delta",141022,20388,20388,141022,1700733,162,142,144,148,122,124
"408","3808","ESCANABA, MI",3048197,0,0,"2015-12","2015"," MI","Escanaba","26041","Delta",358988,45122,45122,358988,3407185,162,142,144,148,122,124
"409","3808","ESCANABA, MI",1980241,5750,930,"2016-12","2016"," MI","Escanaba","26041","Delta",501857,83882,84812,507607,2482098,162,142,144,148,122,124
"410","3808","ESCANABA, MI",1141950,0,0,"2017-12","2017"," MI","Escanaba","26041","Delta",229913,15792,15792,229913,1371863,162,142,144,148,122,124
"411","3808","ESCANABA, MI",985016,70232,3594,"2018-12","2018"," MI","Escanaba","26041","Delta",58442,2760,6354,128674,1043458,162,142,144,148,122,124
"412","3808","ESCANABA, MI",684405,0,0,"2019-12","2019"," MI","Escanaba","26041","Delta",378127,79540,79540,378127,1062532,162,142,144,148,122,124
"413","3808","ESCANABA, MI",770032,0,0,"2020-12","2020"," MI","Escanaba","26041","Delta",0,0,0,0,770032,162,142,144,148,122,124
"414","3808","ESCANABA, MI",1705175,3660,186,"2021-12","2021"," MI","Escanaba","26041","Delta",44083,3763,3949,47743,1749258,162,142,144,148,122,124
"415","2802","EUREKA, CA",22686198,0,0,"2013-12","2013"," CA","Eureka","06023","Humboldt",338937,63972,63972,338937,23025135,133,90,115,71,95,105
"416","2802","EUREKA, CA",19402873,0,0,"2014-12","2014"," CA","Eureka","06023","Humboldt",1317957,140205,140205,1317957,20720830,133,90,115,71,95,105
"417","2802","EUREKA, CA",7584545,27773,105348,"2015-12","2015"," CA","Eureka","06023","Humboldt",1350319,54357,159705,1378092,8934864,133,90,115,71,95,105
"418","2802","EUREKA, CA",11866536,0,0,"2016-12","2016"," CA","Eureka","06023","Humboldt",1793680,72943,72943,1793680,13660216,133,90,115,71,95,105
"419","2802","EUREKA, CA",18586209,2597271,45795087,"2017-12","2017"," CA","Eureka","06023","Humboldt",824865,73355,45868442,3422136,19411074,133,90,115,71,95,105
"420","2802","EUREKA, CA",32109283,5175,2761,"2018-12","2018"," CA","Eureka","06023","Humboldt",545032,108965,111726,550207,32654315,133,90,115,71,95,105
"421","2802","EUREKA, CA",9270000,0,0,"2019-12","2019"," CA","Eureka","06023","Humboldt",3336531,322276,322276,3336531,12606531,133,90,115,71,95,105
"422","2802","EUREKA, CA",6997316,0,0,"2020-12","2020"," CA","Eureka","06023","Humboldt",19256,8451,8451,19256,7016572,133,90,115,71,95,105
"423","2802","EUREKA, CA",16870387,0,0,"2021-12","2021"," CA","Eureka","06023","Humboldt",2219441,258985,258985,2219441,19089828,133,90,115,71,95,105
"424","3006","EVERETT, WA",22374734040,272009770,15355566,"2013-12","2013"," WA","Everett","53061","Snohomish",1321829574,5167302,20522868,1593839344,23696563614,21,62,52,56,23,61
"425","3006","EVERETT, WA",25716468821,86637194,17171360,"2014-12","2014"," WA","Everett","53061","Snohomish",1334928607,6543721,23715081,1421565801,27051397428,21,62,52,56,23,61
"426","3006","EVERETT, WA",29846324248,56534845,10306696,"2015-12","2015"," WA","Everett","53061","Snohomish",1649809251,13264133,23570829,1706344096,31496133499,21,62,52,56,23,61
"427","3006","EVERETT, WA",27358321063,9260763,6508870,"2016-12","2016"," WA","Everett","53061","Snohomish",1367188775,12403652,18912522,1376449538,28725509838,21,62,52,56,23,61
"428","3006","EVERETT, WA",21976833409,37204010,17184676,"2017-12","2017"," WA","Everett","53061","Snohomish",1201019786,10501099,27685775,1238223796,23177853195,21,62,52,56,23,61
"429","3006","EVERETT, WA",18660321957,46459896,11023322,"2018-12","2018"," WA","Everett","53061","Snohomish",889158484,5925238,16948560,935618380,19549480441,21,62,52,56,23,61
"430","3006","EVERETT, WA",16360842038,16714070,10883262,"2019-12","2019"," WA","Everett","53061","Snohomish",1101410194,10037801,20921063,1118124264,17462252232,21,62,52,56,23,61
"431","3006","EVERETT, WA",6180761248,34862893,45468600,"2020-12","2020"," WA","Everett","53061","Snohomish",818076171,15629163,61097763,852939064,6998837419,21,62,52,56,23,61
"432","3006","EVERETT, WA",2791082128,85047401,82570298,"2021-12","2021"," WA","Everett","53061","Snohomish",2029046751,155159081,237729379,2114094152,4820128879,21,62,52,56,23,61
"433","3111","FAIRBANKS, AK",51398437,246141,105,"2013-12","2013"," AK","Fairbanks","02090","Fairbanks North Star",0,0,105,246141,51398437,134,138,134,119,170,170
"434","3111","FAIRBANKS, AK",56469934,0,0,"2014-12","2014"," AK","Fairbanks","02090","Fairbanks North Star",0,0,0,0,56469934,134,138,134,119,170,170
"435","3111","FAIRBANKS, AK",1482319,0,0,"2015-12","2015"," AK","Fairbanks","02090","Fairbanks North Star",0,0,0,0,1482319,134,138,134,119,170,170
"436","3111","FAIRBANKS, AK",1151767,0,0,"2016-12","2016"," AK","Fairbanks","02090","Fairbanks North Star",0,0,0,0,1151767,134,138,134,119,170,170
"437","3111","FAIRBANKS, AK",1994137,0,0,"2017-12","2017"," AK","Fairbanks","02090","Fairbanks North Star",0,0,0,0,1994137,134,138,134,119,170,170
"438","3111","FAIRBANKS, AK",32322300,0,0,"2018-12","2018"," AK","Fairbanks","02090","Fairbanks North Star",0,0,0,0,32322300,134,138,134,119,170,170
"439","3111","FAIRBANKS, AK",222534,0,0,"2019-12","2019"," AK","Fairbanks","02090","Fairbanks North Star",0,0,0,0,222534,134,138,134,119,170,170
"440","3111","FAIRBANKS, AK",5514706,0,0,"2020-12","2020"," AK","Fairbanks","02090","Fairbanks North Star",0,0,0,0,5514706,134,138,134,119,170,170
"441","3111","FAIRBANKS, AK",995214,90927,340000,"2021-12","2021"," AK","Fairbanks","02090","Fairbanks North Star",0,0,340000,90927,995214,134,138,134,119,170,170
"442","0407","FALL RIVER, MA",673772,595100,150803,"2013-12","2013"," MA","Fall River","44005","Newport",385673,102738,253541,980773,1059445,131,117,108,113,97,97
"443","0407","FALL RIVER, MA",530830,302938,129390,"2014-12","2014"," MA","Fall River","44005","Newport",158608,46563,175953,461546,689438,131,117,108,113,97,97
"444","0407","FALL RIVER, MA",510685,400258,5548,"2015-12","2015"," MA","Fall River","44005","Newport",290607,64979,70527,690865,801292,131,117,108,113,97,97
"445","0407","FALL RIVER, MA",86590,34684,650,"2016-12","2016"," MA","Fall River","44005","Newport",487139,170141,170791,521823,573729,131,117,108,113,97,97
"446","0407","FALL RIVER, MA",103890,5416,36,"2017-12","2017"," MA","Fall River","44005","Newport",1288924,334463,334499,1294340,1392814,131,117,108,113,97,97
"447","0407","FALL RIVER, MA",251504,185279,15675,"2018-12","2018"," MA","Fall River","44005","Newport",1254750,362354,378029,1440029,1506254,131,117,108,113,97,97
"448","0407","FALL RIVER, MA",5075835,1243708,58179,"2019-12","2019"," MA","Fall River","44005","Newport",1256421,284630,342809,2500129,6332256,131,117,108,113,97,97
"449","0407","FALL RIVER, MA",47497293,207668,32557,"2020-12","2020"," MA","Fall River","44005","Newport",2142071,430008,462565,2349739,49639364,131,117,108,113,97,97
"450","0407","FALL RIVER, MA",103042750,699816,53410,"2021-12","2021"," MA","Fall River","44005","Newport",3678277,637746,691156,4378093,106721027,131,117,108,113,97,97
"451","1805","FERNANDINA, FL",168807189,63208813,29846797,"2013-12","2013"," FL","Fernandina Beach","12089","Nassau",1460961,243800,30090597,64669774,170268150,97,59,48,48,68,65
"452","1805","FERNANDINA, FL",112388658,59867773,27177909,"2014-12","2014"," FL","Fernandina Beach","12089","Nassau",1170375,394264,27572173,61038148,113559033,97,59,48,48,68,65
"453","1805","FERNANDINA, FL",135903907,69553348,43945965,"2015-12","2015"," FL","Fernandina Beach","12089","Nassau",195379,179179,44125144,69748727,136099286,97,59,48,48,68,65
"454","1805","FERNANDINA, FL",147301715,87511760,59528002,"2016-12","2016"," FL","Fernandina Beach","12089","Nassau",258489,339337,59867339,87770249,147560204,97,59,48,48,68,65
"455","1805","FERNANDINA, FL",139388410,94250655,66040603,"2017-12","2017"," FL","Fernandina Beach","12089","Nassau",1559399,160212,66200815,95810054,140947809,97,59,48,48,68,65
"456","1805","FERNANDINA, FL",154437369,108619400,70153326,"2018-12","2018"," FL","Fernandina Beach","12089","Nassau",396520,182989,70336315,109015920,154833889,97,59,48,48,68,65
"457","1805","FERNANDINA, FL",105764450,81756503,36751900,"2019-12","2019"," FL","Fernandina Beach","12089","Nassau",2398462,1676584,38428484,84154965,108162912,97,59,48,48,68,65
"458","1805","FERNANDINA, FL",87856663,79563155,44590646,"2020-12","2020"," FL","Fernandina Beach","12089","Nassau",31772281,52209449,96800095,111335436,119628944,97,59,48,48,68,65
"459","1805","FERNANDINA, FL",129164084,108774636,62227139,"2021-12","2021"," FL","Fernandina Beach","12089","Nassau",87600508,108373668,170600807,196375144,216764592,97,59,48,48,68,65
"460","0110","FORT KENT, ME",5087794,0,0,"2013-12","2013"," ME","Fort Kent","23003","Aroostook",0,0,0,0,5087794,141,172.5,168,168,170,170
"461","0110","FORT KENT, ME",6716539,0,0,"2014-12","2014"," ME","Fort Kent","23003","Aroostook",0,0,0,0,6716539,141,172.5,168,168,170,170
"462","0110","FORT KENT, ME",7955016,0,0,"2015-12","2015"," ME","Fort Kent","23003","Aroostook",0,0,0,0,7955016,141,172.5,168,168,170,170
"463","0110","FORT KENT, ME",8810898,0,0,"2016-12","2016"," ME","Fort Kent","23003","Aroostook",0,0,0,0,8810898,141,172.5,168,168,170,170
"464","0110","FORT KENT, ME",11382819,0,0,"2017-12","2017"," ME","Fort Kent","23003","Aroostook",0,0,0,0,11382819,141,172.5,168,168,170,170
"465","0110","FORT KENT, ME",14086713,0,0,"2018-12","2018"," ME","Fort Kent","23003","Aroostook",0,0,0,0,14086713,141,172.5,168,168,170,170
"466","0110","FORT KENT, ME",14964197,0,0,"2019-12","2019"," ME","Fort Kent","23003","Aroostook",0,0,0,0,14964197,141,172.5,168,168,170,170
"467","0110","FORT KENT, ME",14161035,0,0,"2020-12","2020"," ME","Fort Kent","23003","Aroostook",0,0,0,0,14161035,141,172.5,168,168,170,170
"468","0110","FORT KENT, ME",15091718,0,0,"2021-12","2021"," ME","Fort Kent","23003","Aroostook",0,0,0,0,15091718,141,172.5,168,168,170,170
"469","5205","FORT PIERCE, FL",44337353,5340759,888067,"2013-12","2013"," FL","Fort Pierce","12111","St. Lucie",109234,1817160,2705227,5449993,44446587,126,95,95,102,112,83
"470","5205","FORT PIERCE, FL",66141994,740328,198637,"2014-12","2014"," FL","Fort Pierce","12111","St. Lucie",730500,4889383,5088020,1470828,66872494,126,95,95,102,112,83
"471","5205","FORT PIERCE, FL",9517018,258743,201236,"2015-12","2015"," FL","Fort Pierce","12111","St. Lucie",63965,5807100,6008336,322708,9580983,126,95,95,102,112,83
"472","5205","FORT PIERCE, FL",7968854,152157,26566,"2016-12","2016"," FL","Fort Pierce","12111","St. Lucie",610852,2078976,2105542,763009,8579706,126,95,95,102,112,83
"473","5205","FORT PIERCE, FL",15803339,708889,25340,"2017-12","2017"," FL","Fort Pierce","12111","St. Lucie",80500,45033,70373,789389,15883839,126,95,95,102,112,83
"474","5205","FORT PIERCE, FL",20424295,918568,68737,"2018-12","2018"," FL","Fort Pierce","12111","St. Lucie",148265,1827452,1896189,1066833,20572560,126,95,95,102,112,83
"475","5205","FORT PIERCE, FL",19791366,420163,468231,"2019-12","2019"," FL","Fort Pierce","12111","St. Lucie",258598,2038048,2506279,678761,20049964,126,95,95,102,112,83
"476","5205","FORT PIERCE, FL",6708404,616386,277371,"2020-12","2020"," FL","Fort Pierce","12111","St. Lucie",504758,4359300,4636671,1121144,7213162,126,95,95,102,112,83
"477","5205","FORT PIERCE, FL",19973184,109045,36926,"2021-12","2021"," FL","Fort Pierce","12111","St. Lucie",214560,7257476,7294402,323605,20187744,126,95,95,102,112,83
"478","5311","FREEPORT, TX",1538190083,251277133,201953111,"2013-12","2013"," TX","Freeport","48039","Brazoria",217969049,397005258,598958369,469246182,1756159132,38,22,25,19,40,33
"479","5311","FREEPORT, TX",2695103252,431466521,444382601,"2014-12","2014"," TX","Freeport","48039","Brazoria",202558528,361217273,805599874,634025049,2897661780,38,22,25,19,40,33
"480","5311","FREEPORT, TX",3420609157,890362941,1026486040,"2015-12","2015"," TX","Freeport","48039","Brazoria",254437959,327573037,1354059077,1144800900,3675047116,38,22,25,19,40,33
"481","5311","FREEPORT, TX",3407797501,923222272,1280986277,"2016-12","2016"," TX","Freeport","48039","Brazoria",244781440,308768114,1589754391,1168003712,3652578941,38,22,25,19,40,33
"482","5311","FREEPORT, TX",5568180129,890176754,1272946817,"2017-12","2017"," TX","Freeport","48039","Brazoria",220140729,257841733,1530788550,1110317483,5788320858,38,22,25,19,40,33
"483","5311","FREEPORT, TX",7883448492,1004010374,1448953772,"2018-12","2018"," TX","Freeport","48039","Brazoria",163334878,308611089,1757564861,1167345252,8046783370,38,22,25,19,40,33
"484","5311","FREEPORT, TX",8266034097,826811666,1206374895,"2019-12","2019"," TX","Freeport","48039","Brazoria",179238901,281028699,1487403594,1006050567,8445272998,38,22,25,19,40,33
"485","5311","FREEPORT, TX",8384696208,497720188,498092739,"2020-12","2020"," TX","Freeport","48039","Brazoria",151220487,260998674,759091413,648940675,8535916695,38,22,25,19,40,33
"486","5311","FREEPORT, TX",15798758733,562076552,296508634,"2021-12","2021"," TX","Freeport","48039","Brazoria",310864983,345593618,642102252,872941535,16109623716,38,22,25,19,40,33
"487","3014","FRIDAY HARBOR, WA",420992,0,0,"2013-12","2013"," WA","Friday Harbor","53055","San Juan",860289,42562,42562,860289,1281281,145,146,141,138,131,132
"488","3014","FRIDAY HARBOR, WA",40924509,0,0,"2014-12","2014"," WA","Friday Harbor","53055","San Juan",154083,98438,98438,154083,41078592,145,146,141,138,131,132
"489","3014","FRIDAY HARBOR, WA",3907134,0,0,"2015-12","2015"," WA","Friday Harbor","53055","San Juan",95856,17317,17317,95856,4002990,145,146,141,138,131,132
"490","3014","FRIDAY HARBOR, WA",763584,0,0,"2016-12","2016"," WA","Friday Harbor","53055","San Juan",0,0,0,0,763584,145,146,141,138,131,132
"491","3014","FRIDAY HARBOR, WA",587314,0,0,"2017-12","2017"," WA","Friday Harbor","53055","San Juan",0,0,0,0,587314,145,146,141,138,131,132
"492","3014","FRIDAY HARBOR, WA",1914194,0,0,"2018-12","2018"," WA","Friday Harbor","53055","San Juan",0,0,0,0,1914194,145,146,141,138,131,132
"493","3014","FRIDAY HARBOR, WA",1629129,153458,45000,"2019-12","2019"," WA","Friday Harbor","53055","San Juan",0,0,45000,153458,1629129,145,146,141,138,131,132
"494","3014","FRIDAY HARBOR, WA",16786221,0,0,"2020-12","2020"," WA","Friday Harbor","53055","San Juan",0,0,0,0,16786221,145,146,141,138,131,132
"495","3014","FRIDAY HARBOR, WA",5839740,0,0,"2021-12","2021"," WA","Friday Harbor","53055","San Juan",0,0,0,0,5839740,145,146,141,138,131,132
"496","1410","FRONT ROYAL, VA",521660,0,0,"2014-12","2014"," VA","Front Royal","51187","Warren",0,0,0,0,521660,182,172.5,168,168,170,170
"497","1410","FRONT ROYAL, VA",6576,0,0,"2016-12","2016"," VA","Front Royal","51187","Warren",0,0,0,0,6576,182,172.5,168,168,170,170
"498","1410","FRONT ROYAL, VA",92403,0,0,"2021-12","2021"," VA","Front Royal","51187","Warren",0,0,0,0,92403,182,172.5,168,168,170,170
"499","5310","GALVESTON, TX",2703595695,346922111,59841412,"2013-12","2013"," TX","Galveston","48167","Galveston",647337604,285590733,345432145,994259715,3350933299,48,37,38,42,31,30
"500","5310","GALVESTON, TX",3984283431,243073159,54453147,"2014-12","2014"," TX","Galveston","48167","Galveston",821184117,417918778,472371925,1064257276,4805467548,48,37,38,42,31,30
"501","5310","GALVESTON, TX",2359609283,182262684,93642489,"2015-12","2015"," TX","Galveston","48167","Galveston",740782567,334406852,428049341,923045251,3100391850,48,37,38,42,31,30
"502","5310","GALVESTON, TX",1422050806,80098403,110169151,"2016-12","2016"," TX","Galveston","48167","Galveston",482945500,340508487,450677638,563043903,1904996306,48,37,38,42,31,30
"503","5310","GALVESTON, TX",1601353164,125346403,86275757,"2017-12","2017"," TX","Galveston","48167","Galveston",457018738,316961824,403237581,582365141,2058371902,48,37,38,42,31,30
"504","5310","GALVESTON, TX",2653096503,199150783,87875117,"2018-12","2018"," TX","Galveston","48167","Galveston",462149903,384486937,472362054,661300686,3115246406,48,37,38,42,31,30
"505","5310","GALVESTON, TX",2302766794,206262236,98155547,"2019-12","2019"," TX","Galveston","48167","Galveston",549635710,396895086,495050633,755897946,2852402504,48,37,38,42,31,30
"506","5310","GALVESTON, TX",2071395013,138021054,140680822,"2020-12","2020"," TX","Galveston","48167","Galveston",458056143,197033137,337713959,596077197,2529451156,48,37,38,42,31,30
"507","5310","GALVESTON, TX",2570146512,197401595,94333825,"2021-12","2021"," TX","Galveston","48167","Galveston",713840575,310402629,404736454,911242170,3283987087,48,37,38,42,31,30
"508","3905","GARY, IN",468398,0,0,"2013-12","2013"," IN","Gary","18127","Porter",0,0,0,0,468398,157,136,129,135,130,125
"509","3905","GARY, IN",92608,0,0,"2014-12","2014"," IN","Gary","18127","Porter",11904,2,2,11904,104512,157,136,129,135,130,125
"510","3905","GARY, IN",12035,4800,2005,"2015-12","2015"," IN","Gary","18127","Porter",2220,1,2006,7020,14255,157,136,129,135,130,125
"511","3905","GARY, IN",9283537,0,0,"2016-12","2016"," IN","Gary","18127","Porter",145655,42408,42408,145655,9429192,157,136,129,135,130,125
"512","3905","GARY, IN",14443081,167505,4983,"2017-12","2017"," IN","Gary","18127","Porter",0,0,4983,167505,14443081,157,136,129,135,130,125
"513","3905","GARY, IN",9629026,103030,28179,"2018-12","2018"," IN","Gary","18127","Porter",841856,214636,242815,944886,10470882,157,136,129,135,130,125
"514","3905","GARY, IN",219620,35880,19229,"2019-12","2019"," IN","Gary","18127","Porter",133599,10982,30211,169479,353219,157,136,129,135,130,125
"515","3905","GARY, IN",138558,13216,3369,"2020-12","2020"," IN","Gary","18127","Porter",828,217,3586,14044,139386,157,136,129,135,130,125
"516","3905","GARY, IN",718654,92430,15569,"2021-12","2021"," IN","Gary","18127","Porter",0,0,15569,92430,718654,157,136,129,135,130,125
"517","1602","GEORGETOWN, SC",510088,474825,86631,"2013-12","2013"," SC","Georgetown","45043","Georgetown",508325,93593,180224,983150,1018413,154,104,106,107,87,92
"518","1602","GEORGETOWN, SC",445588,329676,326957,"2014-12","2014"," SC","Georgetown","45043","Georgetown",791458,79922,406879,1121134,1237046,154,104,106,107,87,92
"519","1602","GEORGETOWN, SC",179342,179342,68736,"2015-12","2015"," SC","Georgetown","45043","Georgetown",685857,90022,158758,865199,865199,154,104,106,107,87,92
"520","1602","GEORGETOWN, SC",527581,315735,80943,"2016-12","2016"," SC","Georgetown","45043","Georgetown",4797768,3738084,3819027,5113503,5325349,154,104,106,107,87,92
"521","1602","GEORGETOWN, SC",729714,150540,83741,"2017-12","2017"," SC","Georgetown","45043","Georgetown",3233401,514336,598077,3383941,3963115,154,104,106,107,87,92
"522","1602","GEORGETOWN, SC",1286513,329452,107706,"2018-12","2018"," SC","Georgetown","45043","Georgetown",7855742,1442109,1549815,8185194,9142255,154,104,106,107,87,92
"523","1602","GEORGETOWN, SC",4642542,117500,99015,"2019-12","2019"," SC","Georgetown","45043","Georgetown",8126880,1316980,1415995,8244380,12769422,154,104,106,107,87,92
"524","1602","GEORGETOWN, SC",1760889,735330,218392,"2020-12","2020"," SC","Georgetown","45043","Georgetown",1665087,335117,553509,2400417,3425976,154,104,106,107,87,92
"525","1602","GEORGETOWN, SC",1805968,1105103,110430,"2021-12","2021"," SC","Georgetown","45043","Georgetown",1423290,110738,221168,2528393,3229258,154,104,106,107,87,92
"526","0404","GLOUCESTER, MA",1471983,1452624,549008,"2013-12","2013"," MA","Gloucester","25009","Essex",366265,34042,583050,1818889,1838248,174,116,109,99,118,113
"527","0404","GLOUCESTER, MA",185787,139920,88683,"2014-12","2014"," MA","Gloucester","25009","Essex",250192,11986,100669,390112,435979,174,116,109,99,118,113
"528","0404","GLOUCESTER, MA",74955,24955,108500,"2015-12","2015"," MA","Gloucester","25009","Essex",114432,30604,139104,139387,189387,174,116,109,99,118,113
"529","0404","GLOUCESTER, MA",759904,239162,233493,"2017-12","2017"," MA","Gloucester","25009","Essex",245940,40365,273858,485102,1005844,174,116,109,99,118,113
"530","0404","GLOUCESTER, MA",940927,888743,673644,"2018-12","2018"," MA","Gloucester","25009","Essex",171748,45105,718749,1060491,1112675,174,116,109,99,118,113
"531","0404","GLOUCESTER, MA",1294049,239244,205439,"2019-12","2019"," MA","Gloucester","25009","Essex",73974,29437,234876,313218,1368023,174,116,109,99,118,113
"532","0404","GLOUCESTER, MA",158562,148888,195548,"2020-12","2020"," MA","Gloucester","25009","Essex",390242,293642,489190,539130,548804,174,116,109,99,118,113
"533","0404","GLOUCESTER, MA",102404,85152,114122,"2021-12","2021"," MA","Gloucester","25009","Essex",169943,35448,149570,255095,272347,174,116,109,99,118,113
"534","2010","GRAMERCY, LA",14942303882,35692472,25954810,"2013-12","2013"," LA","Gramercy","22093","St. James",181771956,415472430,441427240,217464428,15124075838,25,34,51,34,52,31
"535","2010","GRAMERCY, LA",17641966961,43213213,58331142,"2014-12","2014"," LA","Gramercy","22093","St. James",137271620,313465599,371796741,180484833,17779238581,25,34,51,34,52,31
"536","2010","GRAMERCY, LA",13540031911,24969379,58644428,"2015-12","2015"," LA","Gramercy","22093","St. James",80610919,342479117,401123545,105580298,13620642830,25,34,51,34,52,31
"537","2010","GRAMERCY, LA",12262410214,115222921,299443378,"2016-12","2016"," LA","Gramercy","22093","St. James",56037040,76181710,375625088,171259961,12318447254,25,34,51,34,52,31
"538","2010","GRAMERCY, LA",14635527579,58405031,153534604,"2017-12","2017"," LA","Gramercy","22093","St. James",105633686,328910316,482444920,164038717,14741161265,25,34,51,34,52,31
"539","2010","GRAMERCY, LA",16459468881,43778187,96249188,"2018-12","2018"," LA","Gramercy","22093","St. James",97800757,361069503,457318691,141578944,16557269638,25,34,51,34,52,31
"540","2010","GRAMERCY, LA",13410308653,133288980,421472635,"2019-12","2019"," LA","Gramercy","22093","St. James",61674083,380049040,801521675,194963063,13471982736,25,34,51,34,52,31
"541","2010","GRAMERCY, LA",12143015826,64324669,266022891,"2020-12","2020"," LA","Gramercy","22093","St. James",43496001,314759472,580782363,107820670,12186511827,25,34,51,34,52,31
"542","2010","GRAMERCY, LA",14096298803,126189179,337376905,"2021-12","2021"," LA","Gramercy","22093","St. James",92073349,408217185,745594090,218262528,14188372152,25,34,51,34,52,31
"543","3816","GRAND HAVEN, MI",195067,107800,17421,"2014-12","2014"," MI","Grand Haven","26139","Ottawa",0,0,17421,107800,195067,161,154,133,140,152,154
"544","3816","GRAND HAVEN, MI",81607,46392,843,"2017-12","2017"," MI","Grand Haven","26139","Ottawa",0,0,843,46392,81607,161,154,133,140,152,154
"545","3816","GRAND HAVEN, MI",5883,0,0,"2018-12","2018"," MI","Grand Haven","26139","Ottawa",11440,320,320,11440,17323,161,154,133,140,152,154
"546","3816","GRAND HAVEN, MI",7180867,0,0,"2020-12","2020"," MI","Grand Haven","26139","Ottawa",0,0,0,0,7180867,161,154,133,140,152,154
"547","3806","GRAND RAPIDS, MI",4271755,0,0,"2013-12","2013"," MI","Grand Rapids","26081","Kent",0,0,0,0,4271755,147,172.5,168,168,170,170
"548","3806","GRAND RAPIDS, MI",10397482,0,0,"2014-12","2014"," MI","Grand Rapids","26081","Kent",0,0,0,0,10397482,147,172.5,168,168,170,170
"549","3806","GRAND RAPIDS, MI",12236162,0,0,"2015-12","2015"," MI","Grand Rapids","26081","Kent",0,0,0,0,12236162,147,172.5,168,168,170,170
"550","3806","GRAND RAPIDS, MI",6455231,0,0,"2016-12","2016"," MI","Grand Rapids","26081","Kent",0,0,0,0,6455231,147,172.5,168,168,170,170
"551","3806","GRAND RAPIDS, MI",10131312,0,0,"2017-12","2017"," MI","Grand Rapids","26081","Kent",0,0,0,0,10131312,147,172.5,168,168,170,170
"552","3806","GRAND RAPIDS, MI",5914054,0,0,"2018-12","2018"," MI","Grand Rapids","26081","Kent",0,0,0,0,5914054,147,172.5,168,168,170,170
"553","3806","GRAND RAPIDS, MI",5328587,0,0,"2019-12","2019"," MI","Grand Rapids","26081","Kent",0,0,0,0,5328587,147,172.5,168,168,170,170
"554","3806","GRAND RAPIDS, MI",320219,0,0,"2020-12","2020"," MI","Grand Rapids","26081","Kent",0,0,0,0,320219,147,172.5,168,168,170,170
"555","3806","GRAND RAPIDS, MI",13391990,0,0,"2021-12","2021"," MI","Grand Rapids","26081","Kent",0,0,0,0,13391990,147,172.5,168,168,170,170
"556","3703","GREEN BAY, WI",57232776,39235,17102,"2013-12","2013"," WI","Green Bay","55009","Brown",9239546,3400574,3417676,9278781,66472322,93,74,99,105,89,69
"557","3703","GREEN BAY, WI",80657104,0,0,"2014-12","2014"," WI","Green Bay","55009","Brown",249685,1722,1722,249685,80906789,93,74,99,105,89,69
"558","3703","GREEN BAY, WI",41439603,287987,86933,"2015-12","2015"," WI","Green Bay","55009","Brown",1813157,127580,214513,2101144,43252760,93,74,99,105,89,69
"559","3703","GREEN BAY, WI",292061200,35716,51885,"2016-12","2016"," WI","Green Bay","55009","Brown",3260562,8235681,8287566,3296278,295321762,93,74,99,105,89,69
"560","3703","GREEN BAY, WI",220577558,1418640,53524,"2017-12","2017"," WI","Green Bay","55009","Brown",120508,10021,63545,1539148,220698066,93,74,99,105,89,69
"561","3703","GREEN BAY, WI",301298375,75430,47883,"2018-12","2018"," WI","Green Bay","55009","Brown",202780,25110000,25157883,278210,301501155,93,74,99,105,89,69
"562","3703","GREEN BAY, WI",247610422,2052621,584913,"2019-12","2019"," WI","Green Bay","55009","Brown",1740629,56797000,57381913,3793250,249351051,93,74,99,105,89,69
"563","3703","GREEN BAY, WI",132929038,1276415,357819,"2020-12","2020"," WI","Green Bay","55009","Brown",7914187,39705171,40062990,9190602,140843225,93,74,99,105,89,69
"564","3703","GREEN BAY, WI",250988604,1130344,487235,"2021-12","2021"," WI","Green Bay","55009","Brown",173186,34265,521500,1303530,251161790,93,74,99,105,89,69
"565","2011","GREENVILLE, MS",172384,0,0,"2013-12","2013"," MS","Greenville","05017","Chicot",71630,11754,11754,71630,244014,181,137,138,137,127,123
"566","2011","GREENVILLE, MS",17515,0,0,"2014-12","2014"," MS","Greenville","05017","Chicot",9469,3188,3188,9469,26984,181,137,138,137,127,123
"567","2011","GREENVILLE, MS",49319,0,0,"2015-12","2015"," MS","Greenville","05017","Chicot",0,0,0,0,49319,181,137,138,137,127,123
"568","2011","GREENVILLE, MS",103258,0,0,"2016-12","2016"," MS","Greenville","05017","Chicot",43079,45797,45797,43079,146337,181,137,138,137,127,123
"569","2011","GREENVILLE, MS",141061,18562,22453,"2017-12","2017"," MS","Greenville","05017","Chicot",28040,25400,47853,46602,169101,181,137,138,137,127,123
"570","2011","GREENVILLE, MS",13386,13386,11536,"2018-12","2018"," MS","Greenville","05017","Chicot",16730,5047,16583,30116,30116,181,137,138,137,127,123
"571","2011","GREENVILLE, MS",83360,31191,4788,"2019-12","2019"," MS","Greenville","05017","Chicot",624374,123030,127818,655565,707734,181,137,138,137,127,123
"572","2011","GREENVILLE, MS",6305,6305,6004,"2020-12","2020"," MS","Greenville","05017","Chicot",221431,36111,42115,227736,227736,181,137,138,137,127,123
"573","2011","GREENVILLE, MS",102648,102648,20160,"2021-12","2021"," MS","Greenville","05017","Chicot",326127,25640,45800,428775,428775,181,137,138,137,127,123
"574","1902","GULFPORT, MS",1013526694,567232249,458726674,"2013-12","2013"," MS","Gulfport","28047","Harrison",1271716288,771255307,1229981981,1838948537,2285242982,51,21,24,21,22,21
"575","1902","GULFPORT, MS",918176570,551103127,412567758,"2014-12","2014"," MS","Gulfport","28047","Harrison",1278096672,1035651094,1448218852,1829199799,2196273242,51,21,24,21,22,21
"576","1902","GULFPORT, MS",694749393,524568727,348909056,"2015-12","2015"," MS","Gulfport","28047","Harrison",1385293360,919068573,1267977629,1909862087,2080042753,51,21,24,21,22,21
"577","1902","GULFPORT, MS",735501457,635132938,438903795,"2016-12","2016"," MS","Gulfport","28047","Harrison",1631838921,983160817,1422064612,2266971859,2367340378,51,21,24,21,22,21
"578","1902","GULFPORT, MS",1025263359,922975228,683185243,"2017-12","2017"," MS","Gulfport","28047","Harrison",1632015171,889997536,1573182779,2554990399,2657278530,51,21,24,21,22,21
"579","1902","GULFPORT, MS",1020647991,958499478,680160297,"2018-12","2018"," MS","Gulfport","28047","Harrison",1424586030,823969133,1504129430,2383085508,2445234021,51,21,24,21,22,21
"580","1902","GULFPORT, MS",925178011,869301369,632475436,"2019-12","2019"," MS","Gulfport","28047","Harrison",1430450458,759921697,1392397133,2299751827,2355628469,51,21,24,21,22,21
"581","1902","GULFPORT, MS",654315964,637161390,628214075,"2020-12","2020"," MS","Gulfport","28047","Harrison",1031867779,808442547,1436656622,1669029169,1686183743,51,21,24,21,22,21
"582","1902","GULFPORT, MS",876226092,854974897,576622797,"2021-12","2021"," MS","Gulfport","28047","Harrison",1481706634,1003393870,1580016667,2336681531,2357932726,51,21,24,21,22,21
"583","0411","HARTFORD, CT",211799713,8250,299,"2013-12","2013"," CT","Hartford","09003","Hartford",0,0,299,8250,211799713,88,130,125,132,93,111
"584","0411","HARTFORD, CT",403331123,13688,3138,"2014-12","2014"," CT","Hartford","09003","Hartford",65628,29988,33126,79316,403396751,88,130,125,132,93,111
"585","0411","HARTFORD, CT",339519354,10881,23,"2015-12","2015"," CT","Hartford","09003","Hartford",0,0,23,10881,339519354,88,130,125,132,93,111
"586","0411","HARTFORD, CT",350217549,7963,192,"2016-12","2016"," CT","Hartford","09003","Hartford",0,0,192,7963,350217549,88,130,125,132,93,111
"587","0411","HARTFORD, CT",273288876,44513,2472,"2017-12","2017"," CT","Hartford","09003","Hartford",82882,28181,30653,127395,273371758,88,130,125,132,93,111
"588","0411","HARTFORD, CT",226354501,382972,79807,"2018-12","2018"," CT","Hartford","09003","Hartford",284759,29277,109084,667731,226639260,88,130,125,132,93,111
"589","0411","HARTFORD, CT",254604846,122024,901,"2019-12","2019"," CT","Hartford","09003","Hartford",950816,28276,29177,1072840,255555662,88,130,125,132,93,111
"590","0411","HARTFORD, CT",184608344,121000,1276,"2020-12","2020"," CT","Hartford","09003","Hartford",5037437,209942,211218,5158437,189645781,88,130,125,132,93,111
"591","0411","HARTFORD, CT",272147414,0,0,"2021-12","2021"," CT","Hartford","09003","Hartford",6483464,322475,322475,6483464,278630878,88,130,125,132,93,111
"592","3202","HILO, HI",15924323,640669,1877240,"2013-12","2013"," HI","Hilo","15001","Hawaii",315750,132414,2009654,956419,16240073,113,83,69,65,107,110
"593","3202","HILO, HI",30840370,1720774,1468607,"2014-12","2014"," HI","Hilo","15001","Hawaii",64745,32600,1501207,1785519,30905115,113,83,69,65,107,110
"594","3202","HILO, HI",46830740,10087064,6524259,"2015-12","2015"," HI","Hilo","15001","Hawaii",843300,184563,6708822,10930364,47674040,113,83,69,65,107,110
"595","3202","HILO, HI",23664183,8295271,9638497,"2016-12","2016"," HI","Hilo","15001","Hawaii",62216,25428,9663925,8357487,23726399,113,83,69,65,107,110
"596","3202","HILO, HI",25958085,11927966,13003229,"2017-12","2017"," HI","Hilo","15001","Hawaii",0,0,13003229,11927966,25958085,113,83,69,65,107,110
"597","3202","HILO, HI",131041917,9041121,5178268,"2018-12","2018"," HI","Hilo","15001","Hawaii",3896211,198913,5377181,12937332,134938128,113,83,69,65,107,110
"598","3202","HILO, HI",35037029,13378372,4997187,"2019-12","2019"," HI","Hilo","15001","Hawaii",184327,52155,5049342,13562699,35221356,113,83,69,65,107,110
"599","3202","HILO, HI",19277656,5376801,4505210,"2020-12","2020"," HI","Hilo","15001","Hawaii",99277,40154,4545364,5476078,19376933,113,83,69,65,107,110
"600","3202","HILO, HI",75477608,40785970,28613591,"2021-12","2021"," HI","Hilo","15001","Hawaii",310568,41576,28655167,41096538,75788176,113,83,69,65,107,110
"601","3201","HONOLULU, HI",272303436,93955349,167722049,"2013-12","2013"," HI","Honolulu","15003","Honolulu",477277166,156524859,324246908,571232515,749580602,70,25,44,37,33,24
"602","3201","HONOLULU, HI",776325193,127346776,160763128,"2014-12","2014"," HI","Honolulu","15003","Honolulu",476379351,154529380,315292508,603726127,1252704544,70,25,44,37,33,24
"603","3201","HONOLULU, HI",440019093,95351644,121651385,"2015-12","2015"," HI","Honolulu","15003","Honolulu",473392859,181815520,303466905,568744503,913411952,70,25,44,37,33,24
"604","3201","HONOLULU, HI",277956051,98329320,125181649,"2016-12","2016"," HI","Honolulu","15003","Honolulu",485364192,170932381,296114030,583693512,763320243,70,25,44,37,33,24
"605","3201","HONOLULU, HI",377824124,99489660,135724561,"2017-12","2017"," HI","Honolulu","15003","Honolulu",519424271,924757697,1060482258,618913931,897248395,70,25,44,37,33,24
"606","3201","HONOLULU, HI",450913880,99821122,148080173,"2018-12","2018"," HI","Honolulu","15003","Honolulu",666145093,1205362895,1353443068,765966215,1117058973,70,25,44,37,33,24
"607","3201","HONOLULU, HI",279480499,102688903,149966473,"2019-12","2019"," HI","Honolulu","15003","Honolulu",560306256,982365987,1132332460,662995159,839786755,70,25,44,37,33,24
"608","3201","HONOLULU, HI",135549369,90715901,117164632,"2020-12","2020"," HI","Honolulu","15003","Honolulu",438714919,1001858851,1119023483,529430820,574264288,70,25,44,37,33,24
"609","3201","HONOLULU, HI",170575405,119057708,118705197,"2021-12","2021"," HI","Honolulu","15003","Honolulu",614294528,838342128,957047325,733352236,784869933,70,25,44,37,33,24
"610","0106","HOULTON, ME",1194763408,0,0,"2013-12","2013"," ME","Houlton","23003","Aroostook",0,0,0,0,1194763408,68,172.5,168,168,170,170
"611","0106","HOULTON, ME",1076122809,0,0,"2014-12","2014"," ME","Houlton","23003","Aroostook",0,0,0,0,1076122809,68,172.5,168,168,170,170
"612","0106","HOULTON, ME",968803303,0,0,"2015-12","2015"," ME","Houlton","23003","Aroostook",0,0,0,0,968803303,68,172.5,168,168,170,170
"613","0106","HOULTON, ME",1069451485,0,0,"2016-12","2016"," ME","Houlton","23003","Aroostook",0,0,0,0,1069451485,68,172.5,168,168,170,170
"614","0106","HOULTON, ME",1030474228,0,0,"2017-12","2017"," ME","Houlton","23003","Aroostook",0,0,0,0,1030474228,68,172.5,168,168,170,170
"615","0106","HOULTON, ME",1024257929,0,0,"2018-12","2018"," ME","Houlton","23003","Aroostook",0,0,0,0,1024257929,68,172.5,168,168,170,170
"616","0106","HOULTON, ME",974709723,0,0,"2019-12","2019"," ME","Houlton","23003","Aroostook",0,0,0,0,974709723,68,172.5,168,168,170,170
"617","0106","HOULTON, ME",760845020,0,0,"2020-12","2020"," ME","Houlton","23003","Aroostook",0,0,0,0,760845020,68,172.5,168,168,170,170
"618","0106","HOULTON, ME",899869341,0,0,"2021-12","2021"," ME","Houlton","23003","Aroostook",0,0,0,0,899869341,68,172.5,168,168,170,170
"619","5301","HOUSTON, TX",94171591689,29061612946,12518625201,"2013-12","2013"," TX","Houston","48339","Montgomery",24524136632,8313745183,20832370384,53585749578,118695728321,2,3,2,2,7,3
"620","5301","HOUSTON, TX",92033059014,29007520145,10222793199,"2014-12","2014"," TX","Houston","48339","Montgomery",27344442292,8778298138,19001091337,56351962437,119377501306,2,3,2,2,7,3
"621","5301","HOUSTON, TX",76796022691,29111735721,11510378859,"2015-12","2015"," TX","Houston","48339","Montgomery",30002201078,9494722850,21005101709,59113936799,106798223769,2,3,2,2,7,3
"622","5301","HOUSTON, TX",62983044948,24834153050,11672542728,"2016-12","2016"," TX","Houston","48339","Montgomery",26857065627,9085592639,20758135367,51691218677,89840110575,2,3,2,2,7,3
"623","5301","HOUSTON, TX",71779370038,27453897124,13249170373,"2017-12","2017"," TX","Houston","48339","Montgomery",31346580376,10857373483,24106543856,58800477500,103125950414,2,3,2,2,7,3
"624","5301","HOUSTON, TX",89351738887,29872707050,13310295446,"2018-12","2018"," TX","Houston","48339","Montgomery",36733000427,11713565199,25023860645,66605707477,126084739314,2,3,2,2,7,3
"625","5301","HOUSTON, TX",92460457689,31158799305,15763376032,"2019-12","2019"," TX","Houston","48339","Montgomery",38354871091,11560900621,27324276653,69513670396,130815328780,2,3,2,2,7,3
"626","5301","HOUSTON, TX",73216790359,27543435998,15595458611,"2020-12","2020"," TX","Houston","48339","Montgomery",36473853123,11839640998,27435099609,64017289121,109690643482,2,3,2,2,7,3
"627","5301","HOUSTON, TX",95073964512,30827920158,12473427157,"2021-12","2021"," TX","Houston","48339","Montgomery",50106610938,15265098346,27738525503,80934531096,145180575450,2,3,2,2,7,3
"628","1910","HUNTSVILLE, AL",3143206361,166842,25440,"2013-12","2013"," AL","Huntsville","01103","Morgan",0,0,25440,166842,3143206361,56,120,100,100,170,170
"629","1910","HUNTSVILLE, AL",3176876217,0,0,"2014-12","2014"," AL","Huntsville","01103","Morgan",0,0,0,0,3176876217,56,120,100,100,170,170
"630","1910","HUNTSVILLE, AL",2652280164,515503,167208,"2015-12","2015"," AL","Huntsville","01103","Morgan",0,0,167208,515503,2652280164,56,120,100,100,170,170
"631","1910","HUNTSVILLE, AL",1977785146,473224,1077776,"2016-12","2016"," AL","Huntsville","01103","Morgan",0,0,1077776,473224,1977785146,56,120,100,100,170,170
"632","1910","HUNTSVILLE, AL",1762879956,469002,501640,"2017-12","2017"," AL","Huntsville","01103","Morgan",0,0,501640,469002,1762879956,56,120,100,100,170,170
"633","1910","HUNTSVILLE, AL",1289810543,1687200,126690,"2018-12","2018"," AL","Huntsville","01103","Morgan",0,0,126690,1687200,1289810543,56,120,100,100,170,170
"634","1910","HUNTSVILLE, AL",1301107851,2152781,336151,"2019-12","2019"," AL","Huntsville","01103","Morgan",0,0,336151,2152781,1301107851,56,120,100,100,170,170
"635","1910","HUNTSVILLE, AL",1026216993,317636,68508,"2020-12","2020"," AL","Huntsville","01103","Morgan",0,0,68508,317636,1026216993,56,120,100,100,170,170
"636","1910","HUNTSVILLE, AL",1274855972,176866,124494,"2021-12","2021"," AL","Huntsville","01103","Morgan",0,0,124494,176866,1274855972,56,120,100,100,170,170
"637","4117","HURON, OH",45722107,0,0,"2013-12","2013"," OH","Huron","39043","Erie",34274,6907,6907,34274,45756381,123,123,168,168,91,101
"638","4117","HURON, OH",7732245,0,0,"2014-12","2014"," OH","Huron","39043","Erie",35879,19600,19600,35879,7768124,123,123,168,168,91,101
"639","4117","HURON, OH",2112110,0,0,"2015-12","2015"," OH","Huron","39043","Erie",219887,7702,7702,219887,2331997,123,123,168,168,91,101
"640","4117","HURON, OH",5567573,0,0,"2016-12","2016"," OH","Huron","39043","Erie",506817,54463,54463,506817,6074390,123,123,168,168,91,101
"641","4117","HURON, OH",5512566,0,0,"2017-12","2017"," OH","Huron","39043","Erie",243895,18373,18373,243895,5756461,123,123,168,168,91,101
"642","4117","HURON, OH",8104473,0,0,"2018-12","2018"," OH","Huron","39043","Erie",37084,3726,3726,37084,8141557,123,123,168,168,91,101
"643","4117","HURON, OH",7927795,0,0,"2019-12","2019"," OH","Huron","39043","Erie",854308,70314,70314,854308,8782103,123,123,168,168,91,101
"644","4117","HURON, OH",63015508,0,0,"2020-12","2020"," OH","Huron","39043","Erie",12933920,1132095,1132095,12933920,75949428,123,123,168,168,91,101
"645","4117","HURON, OH",86901516,0,0,"2021-12","2021"," OH","Huron","39043","Erie",2083716,140488,140488,2083716,88985232,123,123,168,168,91,101
"646","3604","INTERNATIONAL FALLS-RANIER, MN",6190908145,252128860,216161091,"2013-12","2013"," MN","International Falls","27071","Koochiching",524616370,126944232,343105323,776745230,6715524515,43,44,43,36,32,42
"647","3604","INTERNATIONAL FALLS-RANIER, MN",5316556538,146980899,141908591,"2014-12","2014"," MN","International Falls","27071","Koochiching",676626104,141175335,283083926,823607003,5993182642,43,44,43,36,32,42
"648","3604","INTERNATIONAL FALLS-RANIER, MN",4812021464,132225105,121769372,"2015-12","2015"," MN","International Falls","27071","Koochiching",774511476,169405572,291174944,906736581,5586532940,43,44,43,36,32,42
"649","3604","INTERNATIONAL FALLS-RANIER, MN",4457658637,124359898,167603445,"2016-12","2016"," MN","International Falls","27071","Koochiching",549878649,126916447,294519892,674238547,5007537286,43,44,43,36,32,42
"650","3604","INTERNATIONAL FALLS-RANIER, MN",4520600346,87882736,83880902,"2017-12","2017"," MN","International Falls","27071","Koochiching",526082229,121634151,205515053,613964965,5046682575,43,44,43,36,32,42
"651","3604","INTERNATIONAL FALLS-RANIER, MN",4796946842,110559155,76055793,"2018-12","2018"," MN","International Falls","27071","Koochiching",442949814,112255605,188311398,553508969,5239896656,43,44,43,36,32,42
"652","3604","INTERNATIONAL FALLS-RANIER, MN",4130629564,74069213,102160764,"2019-12","2019"," MN","International Falls","27071","Koochiching",410386472,100920507,203081271,484455685,4541016036,43,44,43,36,32,42
"653","3604","INTERNATIONAL FALLS-RANIER, MN",3423613071,97639634,202217305,"2020-12","2020"," MN","International Falls","27071","Koochiching",393203545,91913381,294130686,490843179,3816816616,43,44,43,36,32,42
"654","3604","INTERNATIONAL FALLS-RANIER, MN",4649225593,102734785,144416904,"2021-12","2021"," MN","International Falls","27071","Koochiching",501473006,126474488,270891392,604207791,5150698599,43,44,43,36,32,42
"655","1803","JACKSONVILLE, FL",12372831263,3882329008,1081636722,"2013-12","2013"," FL","Jacksonville","12089","Nassau",4055254446,1194843667,2276480389,7937583454,16428085709,27,16,16,17,15,16
"656","1803","JACKSONVILLE, FL",10890812431,4107466348,1061710188,"2014-12","2014"," FL","Jacksonville","12089","Nassau",4795479971,1330542940,2392253128,8902946319,15686292402,27,16,16,17,15,16
"657","1803","JACKSONVILLE, FL",8218439420,3070908125,875623046,"2015-12","2015"," FL","Jacksonville","12089","Nassau",4983906640,3863349667,4738972713,8054814765,13202346060,27,16,16,17,15,16
"658","1803","JACKSONVILLE, FL",6131334742,2925959012,1014565769,"2016-12","2016"," FL","Jacksonville","12089","Nassau",5296957141,3769401460,4783967229,8222916153,11428291883,27,16,16,17,15,16
"659","1803","JACKSONVILLE, FL",6081081624,3251489089,1094150135,"2017-12","2017"," FL","Jacksonville","12089","Nassau",7064905878,2693495648,3787645783,10316394967,13145987502,27,16,16,17,15,16
"660","1803","JACKSONVILLE, FL",6525288967,3054732352,1066502901,"2018-12","2018"," FL","Jacksonville","12089","Nassau",6667247812,1996639052,3063141953,9721980164,13192536779,27,16,16,17,15,16
"661","1803","JACKSONVILLE, FL",6588132153,3165927290,922553711,"2019-12","2019"," FL","Jacksonville","12089","Nassau",6806075267,2161077046,3083630757,9972002557,13394207420,27,16,16,17,15,16
"662","1803","JACKSONVILLE, FL",5131933536,2784452045,864303929,"2020-12","2020"," FL","Jacksonville","12089","Nassau",6143519035,2144679294,3008983223,8927971080,11275452571,27,16,16,17,15,16
"663","1803","JACKSONVILLE, FL",6345789698,3666530053,958775079,"2021-12","2021"," FL","Jacksonville","12089","Nassau",6715936538,2167232360,3126007439,10382466591,13061726236,27,16,16,17,15,16
"664","0122","JONESPORT, ME",136001,136001,36430,"2016-12","2016"," ME","Jonesport","23029","Washington",0,0,36430,136001,136001,183,140,122,120,170,170
"665","3101","JUNEAU, AK",246482013,180304,98816,"2013-12","2013"," AK","Juneau","02105","Hoonah-Angoon",344711,3902,102718,525015,246826724,89,115,89,97,136,138
"666","3101","JUNEAU, AK",203264572,0,0,"2014-12","2014"," AK","Juneau","02105","Hoonah-Angoon",69612,19375,19375,69612,203334184,89,115,89,97,136,138
"667","3101","JUNEAU, AK",167511092,37367,748,"2015-12","2015"," AK","Juneau","02105","Hoonah-Angoon",0,0,748,37367,167511092,89,115,89,97,136,138
"668","3101","JUNEAU, AK",243453870,220000,27452,"2016-12","2016"," AK","Juneau","02105","Hoonah-Angoon",35922,5927,33379,255922,243489792,89,115,89,97,136,138
"669","3101","JUNEAU, AK",141970608,483949,9,"2017-12","2017"," AK","Juneau","02105","Hoonah-Angoon",6884,2,11,490833,141977492,89,115,89,97,136,138
"670","3101","JUNEAU, AK",247679752,11324709,2889874,"2018-12","2018"," AK","Juneau","02105","Hoonah-Angoon",268455,41425,2931299,11593164,247948207,89,115,89,97,136,138
"671","3101","JUNEAU, AK",229516884,0,0,"2019-12","2019"," AK","Juneau","02105","Hoonah-Angoon",0,0,0,0,229516884,89,115,89,97,136,138
"672","3101","JUNEAU, AK",232533270,0,0,"2020-12","2020"," AK","Juneau","02105","Hoonah-Angoon",7070,340,340,7070,232540340,89,115,89,97,136,138
"673","3101","JUNEAU, AK",336810220,0,0,"2021-12","2021"," AK","Juneau","02105","Hoonah-Angoon",0,0,0,0,336810220,89,115,89,97,136,138
"674","3203","KAHULUI, HI",57550750,4349512,2661882,"2013-12","2013"," HI","Kahului","15009","Maui",116894,14112,2675994,4466406,57667644,139,99,82,81,115,118
"675","3203","KAHULUI, HI",8861281,6976907,1809111,"2014-12","2014"," HI","Kahului","15009","Maui",2018026,138643,1947754,8994933,10879307,139,99,82,81,115,118
"676","3203","KAHULUI, HI",5467190,2780812,1727667,"2015-12","2015"," HI","Kahului","15009","Maui",91758,26504,1754171,2872570,5558948,139,99,82,81,115,118
"677","3203","KAHULUI, HI",7102148,2665845,2994795,"2016-12","2016"," HI","Kahului","15009","Maui",15717,19026,3013821,2681562,7117865,139,99,82,81,115,118
"678","3203","KAHULUI, HI",3727951,3006566,4339953,"2017-12","2017"," HI","Kahului","15009","Maui",0,0,4339953,3006566,3727951,139,99,82,81,115,118
"679","3203","KAHULUI, HI",5139327,2731473,2467623,"2018-12","2018"," HI","Kahului","15009","Maui",83719,16824,2484447,2815192,5223046,139,99,82,81,115,118
"680","3203","KAHULUI, HI",3076049,1498406,894123,"2019-12","2019"," HI","Kahului","15009","Maui",55337,7819,901942,1553743,3131386,139,99,82,81,115,118
"681","3203","KAHULUI, HI",1300715,705438,1207070,"2020-12","2020"," HI","Kahului","15009","Maui",0,0,1207070,705438,1300715,139,99,82,81,115,118
"682","3203","KAHULUI, HI",5517730,620520,2910956,"2021-12","2021"," HI","Kahului","15009","Maui",258716,222310,3133266,879236,5776446,139,99,82,81,115,118
"683","2909","KALAMA, WA",3216136703,556511,202681,"2013-12","2013"," WA","Kalama","53015","Cowlitz",11891822,14325067,14527748,12448333,3228028525,46,49,60,40,62,60
"684","2909","KALAMA, WA",3005132215,2190838,12687943,"2014-12","2014"," WA","Kalama","53015","Cowlitz",1105126,332028,13019971,3295964,3006237341,46,49,60,40,62,60
"685","2909","KALAMA, WA",3040853011,10225977,46557988,"2015-12","2015"," WA","Kalama","53015","Cowlitz",495973,188370,46746358,10721950,3041348984,46,49,60,40,62,60
"686","2909","KALAMA, WA",3186591351,29517434,148718874,"2016-12","2016"," WA","Kalama","53015","Cowlitz",263599,51252,148770126,29781033,3186854950,46,49,60,40,62,60
"687","2909","KALAMA, WA",3363889024,44129781,235840559,"2017-12","2017"," WA","Kalama","53015","Cowlitz",2552718,331897,236172456,46682499,3366441742,46,49,60,40,62,60
"688","2909","KALAMA, WA",3202946996,1675151,8230000,"2018-12","2018"," WA","Kalama","53015","Cowlitz",11849370,14968330,23198330,13524521,3214796366,46,49,60,40,62,60
"689","2909","KALAMA, WA",3603368178,37224334,167400000,"2019-12","2019"," WA","Kalama","53015","Cowlitz",222966,151168,167551168,37447300,3603591144,46,49,60,40,62,60
"690","2909","KALAMA, WA",4268045778,16146450,7.5e+07,"2020-12","2020"," WA","Kalama","53015","Cowlitz",24416157,59309858,134309858,40562607,4292461935,46,49,60,40,62,60
"691","2909","KALAMA, WA",5820784916,107324930,343120000,"2021-12","2021"," WA","Kalama","53015","Cowlitz",189285394,183975371,527095371,296610324,6010070310,46,49,60,40,62,60
"692","3102","KETCHIKAN, AK",62571722,917246,439046,"2013-12","2013"," AK","Ketchikan","02130","Ketchikan Gateway",0,0,439046,917246,62571722,109,110,96,98,105,99
"693","3102","KETCHIKAN, AK",51934195,311812,148754,"2014-12","2014"," AK","Ketchikan","02130","Ketchikan Gateway",0,0,148754,311812,51934195,109,110,96,98,105,99
"694","3102","KETCHIKAN, AK",64752080,80000,18144,"2015-12","2015"," AK","Ketchikan","02130","Ketchikan Gateway",17369,3346,21490,97369,64769449,109,110,96,98,105,99
"695","3102","KETCHIKAN, AK",73887100,5175968,1847926,"2016-12","2016"," AK","Ketchikan","02130","Ketchikan Gateway",1252131,256342,2104268,6428099,75139231,109,110,96,98,105,99
"696","3102","KETCHIKAN, AK",45010003,908518,313138,"2017-12","2017"," AK","Ketchikan","02130","Ketchikan Gateway",433939,99460,412598,1342457,45443942,109,110,96,98,105,99
"697","3102","KETCHIKAN, AK",64116871,497164,170108,"2018-12","2018"," AK","Ketchikan","02130","Ketchikan Gateway",301135,131809,301917,798299,64418006,109,110,96,98,105,99
"698","3102","KETCHIKAN, AK",70559100,0,0,"2019-12","2019"," AK","Ketchikan","02130","Ketchikan Gateway",2329,14,14,2329,70561429,109,110,96,98,105,99
"699","3102","KETCHIKAN, AK",95672696,0,0,"2020-12","2020"," AK","Ketchikan","02130","Ketchikan Gateway",510373,42846,42846,510373,96183069,109,110,96,98,105,99
"700","3102","KETCHIKAN, AK",53432221,0,0,"2021-12","2021"," AK","Ketchikan","02130","Ketchikan Gateway",3874550,1566880,1566880,3874550,57306771,109,110,96,98,105,99
"701","5202","KEY WEST, FL",23073380,1781432,420060,"2013-12","2013"," FL","Key West","12087","Monroe",83596,23552,443612,1865028,23156976,120,107,84,88,110,115
"702","5202","KEY WEST, FL",33614879,8584604,2386382,"2014-12","2014"," FL","Key West","12087","Monroe",305749,47646,2434028,8890353,33920628,120,107,84,88,110,115
"703","5202","KEY WEST, FL",64583401,6027652,2318991,"2015-12","2015"," FL","Key West","12087","Monroe",132601,64396,2383387,6160253,64716002,120,107,84,88,110,115
"704","5202","KEY WEST, FL",42060453,3221951,347004,"2016-12","2016"," FL","Key West","12087","Monroe",1598223,151912,498916,4820174,43658676,120,107,84,88,110,115
"705","5202","KEY WEST, FL",21575661,427707,181139,"2017-12","2017"," FL","Key West","12087","Monroe",201766,42650,223789,629473,21777427,120,107,84,88,110,115
"706","5202","KEY WEST, FL",21358633,837007,614471,"2018-12","2018"," FL","Key West","12087","Monroe",251555,54070,668541,1088562,21610188,120,107,84,88,110,115
"707","5202","KEY WEST, FL",24785813,877982,287279,"2019-12","2019"," FL","Key West","12087","Monroe",56267,5782,293061,934249,24842080,120,107,84,88,110,115
"708","5202","KEY WEST, FL",16220652,495665,242483,"2020-12","2020"," FL","Key West","12087","Monroe",297322,29545,272028,792987,16517974,120,107,84,88,110,115
"709","5202","KEY WEST, FL",33038797,358084,148418,"2021-12","2021"," FL","Key West","12087","Monroe",760263,48105,196523,1118347,33799060,120,107,84,88,110,115
"710","3206","KONA, HI",26435873,3312309,3298686,"2013-12","2013"," HI","Kona","15001","Hawaii",457416,74309,3372995,3769725,26893289,105,98,92,80,111,117
"711","3206","KONA, HI",86901977,2298968,689487,"2014-12","2014"," HI","Kona","15001","Hawaii",898911,114878,804365,3197879,87800888,105,98,92,80,111,117
"712","3206","KONA, HI",298642532,233689,656517,"2015-12","2015"," HI","Kona","15001","Hawaii",881683,70529,727046,1115372,299524215,105,98,92,80,111,117
"713","3206","KONA, HI",183531810,318075,863434,"2016-12","2016"," HI","Kona","15001","Hawaii",0,0,863434,318075,183531810,105,98,92,80,111,117
"714","3206","KONA, HI",226558328,961788,4595106,"2017-12","2017"," HI","Kona","15001","Hawaii",278923,72650,4667756,1240711,226837251,105,98,92,80,111,117
"715","3206","KONA, HI",143198625,64693,330541,"2018-12","2018"," HI","Kona","15001","Hawaii",281217,71254,401795,345910,143479842,105,98,92,80,111,117
"716","3206","KONA, HI",60549601,290660,1208716,"2019-12","2019"," HI","Kona","15001","Hawaii",0,0,1208716,290660,60549601,105,98,92,80,111,117
"717","3206","KONA, HI",8399478,1580941,4329029,"2020-12","2020"," HI","Kona","15001","Hawaii",0,0,4329029,1580941,8399478,105,98,92,80,111,117
"718","3206","KONA, HI",4684769,2171646,5137914,"2021-12","2021"," HI","Kona","15001","Hawaii",60657,55016,5192930,2232303,4745426,105,98,92,80,111,117
"719","2017","LAKE CHARLES, LA",5811647553,48157727,67729025,"2013-12","2013"," LA","Lake Charles","22019","Calcasieu",2622864,3226124,70955149,50780591,5814270417,35,40,49,35,46,36
"720","2017","LAKE CHARLES, LA",5456585377,36263379,43139193,"2014-12","2014"," LA","Lake Charles","22019","Calcasieu",28252871,15885299,59024492,64516250,5484838248,35,40,49,35,46,36
"721","2017","LAKE CHARLES, LA",4059514151,88015137,96622329,"2015-12","2015"," LA","Lake Charles","22019","Calcasieu",8696456,53722358,150344687,96711593,4068210607,35,40,49,35,46,36
"722","2017","LAKE CHARLES, LA",3921982450,51849244,112097674,"2016-12","2016"," LA","Lake Charles","22019","Calcasieu",30817888,161578670,273676344,82667132,3952800338,35,40,49,35,46,36
"723","2017","LAKE CHARLES, LA",6643271997,37162363,127951759,"2017-12","2017"," LA","Lake Charles","22019","Calcasieu",105711015,527987090,655938849,142873378,6748983012,35,40,49,35,46,36
"724","2017","LAKE CHARLES, LA",9331596012,7435369,37848657,"2018-12","2018"," LA","Lake Charles","22019","Calcasieu",98929895,416149860,453998517,106365264,9430525907,35,40,49,35,46,36
"725","2017","LAKE CHARLES, LA",9637358461,141855148,339276602,"2019-12","2019"," LA","Lake Charles","22019","Calcasieu",62541017,487447005,826723607,204396165,9699899478,35,40,49,35,46,36
"726","2017","LAKE CHARLES, LA",5550472658,98663917,343266360,"2020-12","2020"," LA","Lake Charles","22019","Calcasieu",191629577,124051155,467317515,290293494,5742102235,35,40,49,35,46,36
"727","2017","LAKE CHARLES, LA",9881492819,201464942,496137155,"2021-12","2021"," LA","Lake Charles","22019","Calcasieu",687938291,261134637,757271792,889403233,10569431110,35,40,49,35,46,36
"728","0118","LIMESTONE, ME",5314936,0,0,"2013-12","2013"," ME","Limestone","23003","Aroostook",0,0,0,0,5314936,159,172.5,168,168,170,170
"729","0118","LIMESTONE, ME",4318336,0,0,"2014-12","2014"," ME","Limestone","23003","Aroostook",0,0,0,0,4318336,159,172.5,168,168,170,170
"730","0118","LIMESTONE, ME",2055215,0,0,"2015-12","2015"," ME","Limestone","23003","Aroostook",0,0,0,0,2055215,159,172.5,168,168,170,170
"731","0118","LIMESTONE, ME",1775376,0,0,"2016-12","2016"," ME","Limestone","23003","Aroostook",0,0,0,0,1775376,159,172.5,168,168,170,170
"732","0118","LIMESTONE, ME",3358992,0,0,"2017-12","2017"," ME","Limestone","23003","Aroostook",0,0,0,0,3358992,159,172.5,168,168,170,170
"733","0118","LIMESTONE, ME",2716822,0,0,"2018-12","2018"," ME","Limestone","23003","Aroostook",0,0,0,0,2716822,159,172.5,168,168,170,170
"734","0118","LIMESTONE, ME",2478477,0,0,"2019-12","2019"," ME","Limestone","23003","Aroostook",0,0,0,0,2478477,159,172.5,168,168,170,170
"735","0118","LIMESTONE, ME",1056472,0,0,"2020-12","2020"," ME","Limestone","23003","Aroostook",0,0,0,0,1056472,159,172.5,168,168,170,170
"736","0118","LIMESTONE, ME",793191,0,0,"2021-12","2021"," ME","Limestone","23003","Aroostook",0,0,0,0,793191,159,172.5,168,168,170,170
"737","2709","LONG BEACH, CA",39627998168,29427466453,12719575846,"2013-12","2013"," CA","Long Beach","06059","Orange",62234797660,9258136600,21977712446,91662264113,101862795828,3,4,4,4,3,4
"738","2709","LONG BEACH, CA",37191955958,28715019450,12020042189,"2014-12","2014"," CA","Long Beach","06059","Orange",59809081663,9826682627,21846724816,88524101113,97001037621,3,4,4,4,3,4
"739","2709","LONG BEACH, CA",31103943018,24295337825,10337892040,"2015-12","2015"," CA","Long Beach","06059","Orange",54224272172,9881394052,20219286092,78519609997,85328215190,3,4,4,4,3,4
"740","2709","LONG BEACH, CA",32420163662,26544168090,12369497288,"2016-12","2016"," CA","Long Beach","06059","Orange",51044094578,9344834334,21714331622,77588262668,83464258240,3,4,4,4,3,4
"741","2709","LONG BEACH, CA",33798992658,28281655276,11952314132,"2017-12","2017"," CA","Long Beach","06059","Orange",58532136755,10637325411,22589639543,86813792031,92331129413,3,4,4,4,3,4
"742","2709","LONG BEACH, CA",34153150631,29855797235,12965024019,"2018-12","2018"," CA","Long Beach","06059","Orange",65489298326,11427968903,24392992922,95345095561,99642448957,3,4,4,4,3,4
"743","2709","LONG BEACH, CA",31148450647,28090687493,11543984644,"2019-12","2019"," CA","Long Beach","06059","Orange",53617004511,9742980378,21286965022,81707692004,84765455158,3,4,4,4,3,4
"744","2709","LONG BEACH, CA",28972701203,26449283967,11312094860,"2020-12","2020"," CA","Long Beach","06059","Orange",56599908185,10949919083,22262013943,83049192152,85572609388,3,4,4,4,3,4
"745","2709","LONG BEACH, CA",26819420865,23527672770,10675544611,"2021-12","2021"," CA","Long Beach","06059","Orange",65842066510,12736243656,23411788267,89369739280,92661487375,3,4,4,4,3,4
"746","2905","LONGVIEW, WA",3138083345,18235224,77378308,"2013-12","2013"," WA","Longview","53015","Cowlitz",209123,136236,77514544,18444347,3138292468,50,56,66,46,67,67
"747","2905","LONGVIEW, WA",3315908391,14445277,61666468,"2014-12","2014"," WA","Longview","53015","Cowlitz",12979007,401603,62068071,27424284,3328887398,50,56,66,46,67,67
"748","2905","LONGVIEW, WA",2124336819,12491111,75416214,"2015-12","2015"," WA","Longview","53015","Cowlitz",8952986,23253202,98669416,21444097,2133289805,50,56,66,46,67,67
"749","2905","LONGVIEW, WA",2555656397,32107733,200998618,"2016-12","2016"," WA","Longview","53015","Cowlitz",11924804,1472887,202471505,44032537,2567581201,50,56,66,46,67,67
"750","2905","LONGVIEW, WA",2644401458,11478749,59678592,"2017-12","2017"," WA","Longview","53015","Cowlitz",20693810,22148772,81827364,32172559,2665095268,50,56,66,46,67,67
"751","2905","LONGVIEW, WA",2901268757,13023197,21789569,"2018-12","2018"," WA","Longview","53015","Cowlitz",2841884,351659,22141228,15865081,2904110641,50,56,66,46,67,67
"752","2905","LONGVIEW, WA",1975743443,3351008,9133861,"2019-12","2019"," WA","Longview","53015","Cowlitz",8058230,26914216,36048077,11409238,1983801673,50,56,66,46,67,67
"753","2905","LONGVIEW, WA",2121580205,19247460,80042100,"2020-12","2020"," WA","Longview","53015","Cowlitz",46134843,54484584,134526684,65382303,2167715048,50,56,66,46,67,67
"754","2905","LONGVIEW, WA",3390573677,11785953,41052076,"2021-12","2021"," WA","Longview","53015","Cowlitz",18244047,20705555,61757631,30030000,3408817724,50,56,66,46,67,67
"755","4121","LORAIN, OH",79646,15249,1229,"2015-12","2015"," OH","Lorain","39093","Lorain",456416,100675,101904,471665,536062,140,134,143,145,109,121
"756","4121","LORAIN, OH",29614614,40528,21546,"2017-12","2017"," OH","Lorain","39093","Lorain",8153,413,21959,48681,29622767,140,134,143,145,109,121
"757","4121","LORAIN, OH",10773201,0,0,"2018-12","2018"," OH","Lorain","39093","Lorain",15878,4010,4010,15878,10789079,140,134,143,145,109,121
"758","4121","LORAIN, OH",15001800,0,0,"2019-12","2019"," OH","Lorain","39093","Lorain",366106,28530,28530,366106,15367906,140,134,143,145,109,121
"759","4121","LORAIN, OH",4590085,0,0,"2020-12","2020"," OH","Lorain","39093","Lorain",397735,35550,35550,397735,4987820,140,134,143,145,109,121
"760","4121","LORAIN, OH",3360628,0,0,"2021-12","2021"," OH","Lorain","39093","Lorain",1304995,60356,60356,1304995,4665623,140,134,143,145,109,121
"761","2704","LOS ANGELES, CA",40783015641,31315611020,12579231205,"2013-12","2013"," CA","Los Angeles","06037","Los Angeles",216366137735,34226275184,46805506389,247681748755,257149153376,1,1,1,1,1,1
"762","2704","LOS ANGELES, CA",39953672208,32292459930,13445655925,"2014-12","2014"," CA","Los Angeles","06037","Los Angeles",222370305176,36467118919,49912774844,254662765106,262323977384,1,1,1,1,1,1
"763","2704","LOS ANGELES, CA",31716873671,25337360502,11138449413,"2015-12","2015"," CA","Los Angeles","06037","Los Angeles",211494416366,36720954669,47859404082,236831776868,243211290037,1,1,1,1,1,1
"764","2704","LOS ANGELES, CA",32727187415,27372053315,13751241400,"2016-12","2016"," CA","Los Angeles","06037","Los Angeles",218044689760,37512970092,51264211492,245416743075,250771877175,1,1,1,1,1,1
"765","2704","LOS ANGELES, CA",35496551629,31372079858,16144648125,"2017-12","2017"," CA","Los Angeles","06037","Los Angeles",224901223859,38217547248,54362195373,256273303717,260397775488,1,1,1,1,1,1
"766","2704","LOS ANGELES, CA",35813488809,32797829599,17466278809,"2018-12","2018"," CA","Los Angeles","06037","Los Angeles",236602119218,39461931904,56928210713,269399948817,272415608027,1,1,1,1,1,1
"767","2704","LOS ANGELES, CA",31917578574,29312675800,15991033693,"2019-12","2019"," CA","Los Angeles","06037","Los Angeles",219743099736,36354229752,52345263445,249055775536,251660678310,1,1,1,1,1,1
"768","2704","LOS ANGELES, CA",28462143835,26091337606,15517154669,"2020-12","2020"," CA","Los Angeles","06037","Los Angeles",211290843082,36968541774,52485696443,237382180688,239752986917,1,1,1,1,1,1
"769","2704","LOS ANGELES, CA",26881987666,24340892419,12295956281,"2021-12","2021"," CA","Los Angeles","06037","Los Angeles",242304613204,42492802824,54788759105,266645505623,269186600870,1,1,1,1,1,1
"770","3023","LYNDEN, WA",150480395,0,0,"2013-12","2013"," WA","Lynden","53073","Whatcom",0,0,0,0,150480395,87,172.5,168,168,170,170
"771","3023","LYNDEN, WA",159295866,0,0,"2014-12","2014"," WA","Lynden","53073","Whatcom",0,0,0,0,159295866,87,172.5,168,168,170,170
"772","3023","LYNDEN, WA",99485422,0,0,"2015-12","2015"," WA","Lynden","53073","Whatcom",0,0,0,0,99485422,87,172.5,168,168,170,170
"773","3023","LYNDEN, WA",239477906,0,0,"2016-12","2016"," WA","Lynden","53073","Whatcom",0,0,0,0,239477906,87,172.5,168,168,170,170
"774","3023","LYNDEN, WA",362516044,0,0,"2017-12","2017"," WA","Lynden","53073","Whatcom",0,0,0,0,362516044,87,172.5,168,168,170,170
"775","3023","LYNDEN, WA",398118237,0,0,"2018-12","2018"," WA","Lynden","53073","Whatcom",0,0,0,0,398118237,87,172.5,168,168,170,170
"776","3023","LYNDEN, WA",376031359,0,0,"2019-12","2019"," WA","Lynden","53073","Whatcom",0,0,0,0,376031359,87,172.5,168,168,170,170
"777","3023","LYNDEN, WA",364384622,0,0,"2020-12","2020"," WA","Lynden","53073","Whatcom",0,0,0,0,364384622,87,172.5,168,168,170,170
"778","3023","LYNDEN, WA",589138177,0,0,"2021-12","2021"," WA","Lynden","53073","Whatcom",0,0,0,0,589138177,87,172.5,168,168,170,170
"779","0109","MADAWASKA, ME",44975944,0,0,"2013-12","2013"," ME","Madawaska","23003","Aroostook",0,0,0,0,44975944,127,172.5,168,168,170,170
"780","0109","MADAWASKA, ME",44662551,0,0,"2014-12","2014"," ME","Madawaska","23003","Aroostook",0,0,0,0,44662551,127,172.5,168,168,170,170
"781","0109","MADAWASKA, ME",32394936,0,0,"2015-12","2015"," ME","Madawaska","23003","Aroostook",0,0,0,0,32394936,127,172.5,168,168,170,170
"782","0109","MADAWASKA, ME",29786591,0,0,"2016-12","2016"," ME","Madawaska","23003","Aroostook",0,0,0,0,29786591,127,172.5,168,168,170,170
"783","0109","MADAWASKA, ME",30030115,0,0,"2017-12","2017"," ME","Madawaska","23003","Aroostook",0,0,0,0,30030115,127,172.5,168,168,170,170
"784","0109","MADAWASKA, ME",8713155,0,0,"2018-12","2018"," ME","Madawaska","23003","Aroostook",0,0,0,0,8713155,127,172.5,168,168,170,170
"785","0109","MADAWASKA, ME",5680194,0,0,"2019-12","2019"," ME","Madawaska","23003","Aroostook",0,0,0,0,5680194,127,172.5,168,168,170,170
"786","0109","MADAWASKA, ME",3632786,0,0,"2020-12","2020"," ME","Madawaska","23003","Aroostook",0,0,0,0,3632786,127,172.5,168,168,170,170
"787","0109","MADAWASKA, ME",4367501,0,0,"2021-12","2021"," ME","Madawaska","23003","Aroostook",0,0,0,0,4367501,127,172.5,168,168,170,170
"788","3706","MANITOWOC, WI",16313,4763,391,"2015-12","2015"," WI","Manitowoc","55071","Manitowoc",0,0,391,4763,16313,179,139,124,121,145,150
"789","3706","MANITOWOC, WI",1272488,327470,125470,"2018-12","2018"," WI","Manitowoc","55071","Manitowoc",59650,4200,129670,387120,1332138,179,139,124,121,145,150
"790","3706","MANITOWOC, WI",65701,61521,19746,"2019-12","2019"," WI","Manitowoc","55071","Manitowoc",0,0,19746,61521,65701,179,139,124,121,145,150
"791","3706","MANITOWOC, WI",206085,0,0,"2020-12","2020"," WI","Manitowoc","55071","Manitowoc",12432,800,800,12432,218517,179,139,124,121,145,150
"792","3702","MARINETTE, WI",4902120,108068,7394,"2013-12","2013"," WI","Marinette","55075","Marinette",11419,2049,9443,119487,4913539,171,151,119,136,153,152
"793","3702","MARINETTE, WI",3099325,0,0,"2014-12","2014"," WI","Marinette","55075","Marinette",0,0,0,0,3099325,171,151,119,136,153,152
"794","3702","MARINETTE, WI",42483,0,0,"2015-12","2015"," WI","Marinette","55075","Marinette",0,0,0,0,42483,171,151,119,136,153,152
"795","3702","MARINETTE, WI",104451,99470,5617,"2016-12","2016"," WI","Marinette","55075","Marinette",10037,3929,9546,109507,114488,171,151,119,136,153,152
"796","3702","MARINETTE, WI",202566,185340,2304,"2017-12","2017"," WI","Marinette","55075","Marinette",0,0,2304,185340,202566,171,151,119,136,153,152
"797","3702","MARINETTE, WI",437009,29248,5455,"2018-12","2018"," WI","Marinette","55075","Marinette",0,0,5455,29248,437009,171,151,119,136,153,152
"798","3702","MARINETTE, WI",69938,24598,1253,"2019-12","2019"," WI","Marinette","55075","Marinette",0,0,1253,24598,69938,171,151,119,136,153,152
"799","3702","MARINETTE, WI",1005584,879243,34641,"2020-12","2020"," WI","Marinette","55075","Marinette",0,0,34641,879243,1005584,171,151,119,136,153,152
"800","3702","MARINETTE, WI",491838,488949,9132,"2021-12","2021"," WI","Marinette","55075","Marinette",0,0,9132,488949,491838,171,151,119,136,153,152
"801","3809","MARQUETTE, MI",313952278,0,0,"2013-12","2013"," MI","Marquette","26103","Marquette",627,376,376,627,313952905,104,144,168,168,117,129
"802","3809","MARQUETTE, MI",169866893,0,0,"2014-12","2014"," MI","Marquette","26103","Marquette",1140323,98175,98175,1140323,171007216,104,144,168,168,117,129
"803","3809","MARQUETTE, MI",93055187,0,0,"2015-12","2015"," MI","Marquette","26103","Marquette",0,0,0,0,93055187,104,144,168,168,117,129
"804","3809","MARQUETTE, MI",66006979,0,0,"2016-12","2016"," MI","Marquette","26103","Marquette",0,0,0,0,66006979,104,144,168,168,117,129
"805","3809","MARQUETTE, MI",94058030,0,0,"2017-12","2017"," MI","Marquette","26103","Marquette",44928,11404,11404,44928,94102958,104,144,168,168,117,129
"806","3809","MARQUETTE, MI",113161571,0,0,"2018-12","2018"," MI","Marquette","26103","Marquette",12858,4800,4800,12858,113174429,104,144,168,168,117,129
"807","3809","MARQUETTE, MI",106631403,0,0,"2019-12","2019"," MI","Marquette","26103","Marquette",11000,956,956,11000,106642403,104,144,168,168,117,129
"808","3809","MARQUETTE, MI",92795797,0,0,"2020-12","2020"," MI","Marquette","26103","Marquette",0,0,0,0,92795797,104,144,168,168,117,129
"809","3809","MARQUETTE, MI",6733479,0,0,"2021-12","2021"," MI","Marquette","26103","Marquette",1205306,125665,125665,1205306,7938785,104,144,168,168,117,129
"810","2820","MARTINEZ, CA",1342813780,0,0,"2013-12","2013"," CA","Martinez","06013","Contra Costa",0,0,0,0,1342813780,73,78,71,60,154,153
"811","2820","MARTINEZ, CA",1077757374,0,0,"2014-12","2014"," CA","Martinez","06013","Contra Costa",0,0,0,0,1077757374,73,78,71,60,154,153
"812","2820","MARTINEZ, CA",509161905,12981,1341,"2015-12","2015"," CA","Martinez","06013","Contra Costa",0,0,1341,12981,509161905,73,78,71,60,154,153
"813","2820","MARTINEZ, CA",539188549,14428977,34486627,"2016-12","2016"," CA","Martinez","06013","Contra Costa",0,0,34486627,14428977,539188549,73,78,71,60,154,153
"814","2820","MARTINEZ, CA",703632786,18956622,38588337,"2017-12","2017"," CA","Martinez","06013","Contra Costa",0,0,38588337,18956622,703632786,73,78,71,60,154,153
"815","2820","MARTINEZ, CA",872001597,18531202,35637318,"2018-12","2018"," CA","Martinez","06013","Contra Costa",18318,5540,35642858,18549520,872019915,73,78,71,60,154,153
"816","2820","MARTINEZ, CA",649163828,0,0,"2019-12","2019"," CA","Martinez","06013","Contra Costa",0,0,0,0,649163828,73,78,71,60,154,153
"817","2820","MARTINEZ, CA",349661996,0,0,"2020-12","2020"," CA","Martinez","06013","Contra Costa",0,0,0,0,349661996,73,78,71,60,154,153
"818","2820","MARTINEZ, CA",10020,0,0,"2021-12","2021"," CA","Martinez","06013","Contra Costa",0,0,0,0,10020,73,78,71,60,154,153
"819","0704","MASSENA, NY",144903982,129085,40129,"2013-12","2013"," NY","Massena","36089","St. Lawrence",793094,113588,153717,922179,145697076,90,126,123,117,106,107
"820","0704","MASSENA, NY",146053281,36749,17488,"2014-12","2014"," NY","Massena","36089","St. Lawrence",530700,85074,102562,567449,146583981,90,126,123,117,106,107
"821","0704","MASSENA, NY",182004832,43919,19848,"2015-12","2015"," NY","Massena","36089","St. Lawrence",909394,82230,102078,953313,182914226,90,126,123,117,106,107
"822","0704","MASSENA, NY",197211032,128374,99909,"2016-12","2016"," NY","Massena","36089","St. Lawrence",782536,95830,195739,910910,197993568,90,126,123,117,106,107
"823","0704","MASSENA, NY",209954250,358606,26933,"2017-12","2017"," NY","Massena","36089","St. Lawrence",1195590,182693,209626,1554196,211149840,90,126,123,117,106,107
"824","0704","MASSENA, NY",261977907,12876,19724,"2018-12","2018"," NY","Massena","36089","St. Lawrence",162919,21677,41401,175795,262140826,90,126,123,117,106,107
"825","0704","MASSENA, NY",244297332,89476,32615,"2019-12","2019"," NY","Massena","36089","St. Lawrence",649071,81869,114484,738547,244946403,90,126,123,117,106,107
"826","0704","MASSENA, NY",222482027,86128,80813,"2020-12","2020"," NY","Massena","36089","St. Lawrence",370108,63983,144796,456236,222852135,90,126,123,117,106,107
"827","0704","MASSENA, NY",238720880,151788,55824,"2021-12","2021"," NY","Massena","36089","St. Lawrence",647321,91075,146899,799109,239368201,90,126,123,117,106,107
"828","0503","MELLVILLE, RI",23835451,0,0,"2013-12","2013"," RI","Mellville","44005","Newport",30084,12806,12806,30084,23865535,153,150,146,147,143,137
"829","0503","MELLVILLE, RI",5244,0,0,"2014-12","2014"," RI","Mellville","44005","Newport",21670,21470,21470,21670,26914,153,150,146,147,143,137
"830","0503","MELLVILLE, RI",56380,24330,3526,"2015-12","2015"," RI","Mellville","44005","Newport",19290,3102,6628,43620,75670,153,150,146,147,143,137
"831","0503","MELLVILLE, RI",4766,0,0,"2016-12","2016"," RI","Mellville","44005","Newport",14392,350,350,14392,19158,153,150,146,147,143,137
"832","0503","MELLVILLE, RI",49458,0,0,"2017-12","2017"," RI","Mellville","44005","Newport",49126,6493,6493,49126,98584,153,150,146,147,143,137
"833","5201","MIAMI, FL",11284989874,7229745207,1837453698,"2013-12","2013"," FL","Miami","12086","Miami-Dade",12028278354,2511020638,4348474336,19258023561,23313268228,18,13,10,13,11,11
"834","5201","MIAMI, FL",10674513186,7176271902,1804547305,"2014-12","2014"," FL","Miami","12086","Miami-Dade",12026245655,2659547951,4464095256,19202517557,22700758841,18,13,10,13,11,11
"835","5201","MIAMI, FL",10291648053,7083641906,1791702736,"2015-12","2015"," FL","Miami","12086","Miami-Dade",13877799496,3244583581,5036286317,20961441402,24169447549,18,13,10,13,11,11
"836","5201","MIAMI, FL",9501901735,7316688584,2106372483,"2016-12","2016"," FL","Miami","12086","Miami-Dade",13530867755,3265140791,5371513274,20847556339,23032769490,18,13,10,13,11,11
"837","5201","MIAMI, FL",9469028135,7661473677,2250119388,"2017-12","2017"," FL","Miami","12086","Miami-Dade",13714843871,3350173538,5600292926,21376317548,23183872006,18,13,10,13,11,11
"838","5201","MIAMI, FL",9826889937,8247623768,2308867842,"2018-12","2018"," FL","Miami","12086","Miami-Dade",15101084843,3483948557,5792816399,23348708611,24927974780,18,13,10,13,11,11
"839","5201","MIAMI, FL",9993057242,8407816615,2434502089,"2019-12","2019"," FL","Miami","12086","Miami-Dade",15535443063,4009850616,6444352705,23943259678,25528500305,18,13,10,13,11,11
"840","5201","MIAMI, FL",7931674263,6594126088,1938875012,"2020-12","2020"," FL","Miami","12086","Miami-Dade",13772996464,4058076629,5996951641,20367122552,21704670727,18,13,10,13,11,11
"841","5201","MIAMI, FL",10220029988,8726232496,2211292679,"2021-12","2021"," FL","Miami","12086","Miami-Dade",17288394667,4515494278,6726786957,26014627163,27508424655,18,13,10,13,11,11
"842","3701","MILWAUKEE, WI",65802008,259302,46881,"2013-12","2013"," WI","Milwaukee","55133","Waukesha",18355137,988384,1035265,18614439,84157145,99,81,68,93,75,73
"843","3701","MILWAUKEE, WI",167358080,2892438,99404,"2014-12","2014"," WI","Milwaukee","55133","Waukesha",5887901,17409948,17509352,8780339,173245981,99,81,68,93,75,73
"844","3701","MILWAUKEE, WI",253088700,2812878,386351,"2015-12","2015"," WI","Milwaukee","55133","Waukesha",8722310,435946,822297,11535188,261811010,99,81,68,93,75,73
"845","3701","MILWAUKEE, WI",155987474,11006964,458967,"2016-12","2016"," WI","Milwaukee","55133","Waukesha",6138322,2745300,3204267,17145286,162125796,99,81,68,93,75,73
"846","3701","MILWAUKEE, WI",178140917,49657342,1956159,"2017-12","2017"," WI","Milwaukee","55133","Waukesha",5335875,389966,2346125,54993217,183476792,99,81,68,93,75,73
"847","3701","MILWAUKEE, WI",98684825,22666494,989912,"2018-12","2018"," WI","Milwaukee","55133","Waukesha",5373939,673674,1663586,28040433,104058764,99,81,68,93,75,73
"848","3701","MILWAUKEE, WI",66990898,4291612,199676,"2019-12","2019"," WI","Milwaukee","55133","Waukesha",8128556,1683683,1883359,12420168,75119454,99,81,68,93,75,73
"849","3701","MILWAUKEE, WI",107790563,9302001,441856,"2020-12","2020"," WI","Milwaukee","55133","Waukesha",3738585,49283331,49725187,13040586,111529148,99,81,68,93,75,73
"850","3701","MILWAUKEE, WI",77966585,4811584,709734,"2021-12","2021"," WI","Milwaukee","55133","Waukesha",22778816,21096913,21806647,27590400,100745401,99,81,68,93,75,73
"851","3501","MINNEAPOLIS-ST. PAUL, MN",2120168975,0,0,"2013-12","2013"," MN","Minneapolis-St. Paul","27054","Hennepin",0,0,0,0,2120168975,62,172.5,168,168,170,170
"852","3501","MINNEAPOLIS-ST. PAUL, MN",2053496200,0,0,"2014-12","2014"," MN","Minneapolis-St. Paul","27054","Hennepin",0,0,0,0,2053496200,62,172.5,168,168,170,170
"853","3501","MINNEAPOLIS-ST. PAUL, MN",2016868279,0,0,"2015-12","2015"," MN","Minneapolis-St. Paul","27054","Hennepin",0,0,0,0,2016868279,62,172.5,168,168,170,170
"854","3501","MINNEAPOLIS-ST. PAUL, MN",1541058703,0,0,"2016-12","2016"," MN","Minneapolis-St. Paul","27054","Hennepin",0,0,0,0,1541058703,62,172.5,168,168,170,170
"855","3501","MINNEAPOLIS-ST. PAUL, MN",1434385585,0,0,"2017-12","2017"," MN","Minneapolis-St. Paul","27054","Hennepin",0,0,0,0,1434385585,62,172.5,168,168,170,170
"856","3501","MINNEAPOLIS-ST. PAUL, MN",1344256503,0,0,"2018-12","2018"," MN","Minneapolis-St. Paul","27054","Hennepin",0,0,0,0,1344256503,62,172.5,168,168,170,170
"857","3501","MINNEAPOLIS-ST. PAUL, MN",1213214773,0,0,"2019-12","2019"," MN","Minneapolis-St. Paul","27054","Hennepin",0,0,0,0,1213214773,62,172.5,168,168,170,170
"858","3501","MINNEAPOLIS-ST. PAUL, MN",635188695,0,0,"2020-12","2020"," MN","Minneapolis-St. Paul","27054","Hennepin",0,0,0,0,635188695,62,172.5,168,168,170,170
"859","3501","MINNEAPOLIS-ST. PAUL, MN",883285825,0,0,"2021-12","2021"," MN","Minneapolis-St. Paul","27054","Hennepin",0,0,0,0,883285825,62,172.5,168,168,170,170
"860","1901","MOBILE, AL",3810158534,1374858926,1411870539,"2013-12","2013"," AL","Mobile","01003","Baldwin",3083242873,1423764531,2835635070,4458101799,6893401407,29,17,18,15,17,18
"861","1901","MOBILE, AL",3736180049,1486118420,1499133226,"2014-12","2014"," AL","Mobile","01003","Baldwin",2837626583,998538874,2497672100,4323745003,6573806632,29,17,18,15,17,18
"862","1901","MOBILE, AL",3656436288,1311446078,1271038164,"2015-12","2015"," AL","Mobile","01003","Baldwin",3512570972,1255796308,2526834472,4824017050,7169007260,29,17,18,15,17,18
"863","1901","MOBILE, AL",4307045743,1595285918,1395055653,"2016-12","2016"," AL","Mobile","01003","Baldwin",3697759745,1285280023,2680335676,5293045663,8004805488,29,17,18,15,17,18
"864","1901","MOBILE, AL",4585145070,2122719574,1604641491,"2017-12","2017"," AL","Mobile","01003","Baldwin",4130817786,1454020465,3058661956,6253537360,8715962856,29,17,18,15,17,18
"865","1901","MOBILE, AL",4718275937,2530317778,1652916254,"2018-12","2018"," AL","Mobile","01003","Baldwin",4308605633,1216775116,2869691370,6838923411,9026881570,29,17,18,15,17,18
"866","1901","MOBILE, AL",4143075313,2490580598,2779884587,"2019-12","2019"," AL","Mobile","01003","Baldwin",5875322147,1537230195,4317114782,8365902745,10018397460,29,17,18,15,17,18
"867","1901","MOBILE, AL",3702926396,2132517208,2580082138,"2020-12","2020"," AL","Mobile","01003","Baldwin",6451579351,1787083707,4367165845,8584096559,10154505747,29,17,18,15,17,18
"868","1901","MOBILE, AL",5024749086,3266291125,2142710642,"2021-12","2021"," AL","Mobile","01003","Baldwin",8217287959,1909061288,4051771930,11483579084,13242037045,29,17,18,15,17,18
"869","2805","MONTEREY, CA",586663,491562,128811,"2013-12","2013"," CA","Monterey","06053","Monterey",151825,15411,144222,643387,738488,150,97,87,79,124,133
"870","2805","MONTEREY, CA",7792389,7695841,294676,"2014-12","2014"," CA","Monterey","06053","Monterey",0,0,294676,7695841,7792389,150,97,87,79,124,133
"871","2805","MONTEREY, CA",1853158,1255751,170605,"2015-12","2015"," CA","Monterey","06053","Monterey",0,0,170605,1255751,1853158,150,97,87,79,124,133
"872","2805","MONTEREY, CA",1177139,935797,119488,"2016-12","2016"," CA","Monterey","06053","Monterey",0,0,119488,935797,1177139,150,97,87,79,124,133
"873","2805","MONTEREY, CA",332953,231223,163951,"2017-12","2017"," CA","Monterey","06053","Monterey",1005268,42041,205992,1236491,1338221,150,97,87,79,124,133
"874","2805","MONTEREY, CA",20377305,324800,49660,"2018-12","2018"," CA","Monterey","06053","Monterey",0,0,49660,324800,20377305,150,97,87,79,124,133
"875","2805","MONTEREY, CA",2314864,1526063,183510,"2019-12","2019"," CA","Monterey","06053","Monterey",403200,76800,260310,1929263,2718064,150,97,87,79,124,133
"876","2805","MONTEREY, CA",25205601,6597322,22261636,"2020-12","2020"," CA","Monterey","06053","Monterey",6888,9225,22270861,6604210,25212489,150,97,87,79,124,133
"877","2805","MONTEREY, CA",690073,685363,154009,"2021-12","2021"," CA","Monterey","06053","Monterey",50643,1,154010,736006,740716,150,97,87,79,124,133
"878","2001","MORGAN CITY, LA",2184406787,4124998,1389944,"2013-12","2013"," LA","Morgan City","22101","St. Mary",92494956,7670836,9060780,96619954,2276901743,52,67,58,62,51,66
"879","2001","MORGAN CITY, LA",1739377839,26160857,13611751,"2014-12","2014"," LA","Morgan City","22101","St. Mary",14607430,2646616,16258367,40768287,1753985269,52,67,58,62,51,66
"880","2001","MORGAN CITY, LA",1290496847,9113128,13772053,"2015-12","2015"," LA","Morgan City","22101","St. Mary",38455802,2915902,16687955,47568930,1328952649,52,67,58,62,51,66
"881","2001","MORGAN CITY, LA",479677132,29408585,8335003,"2016-12","2016"," LA","Morgan City","22101","St. Mary",26998878,3425155,11760158,56407463,506676010,52,67,58,62,51,66
"882","2001","MORGAN CITY, LA",493520638,8362147,1928457,"2017-12","2017"," LA","Morgan City","22101","St. Mary",138851780,14999167,16927624,147213927,632372418,52,67,58,62,51,66
"883","2001","MORGAN CITY, LA",2091859809,100659620,38500643,"2018-12","2018"," LA","Morgan City","22101","St. Mary",93987081,76115499,114616142,194646701,2185846890,52,67,58,62,51,66
"884","2001","MORGAN CITY, LA",2898929474,59246977,14948383,"2019-12","2019"," LA","Morgan City","22101","St. Mary",266741620,22827742,37776125,325988597,3165671094,52,67,58,62,51,66
"885","2001","MORGAN CITY, LA",4039036577,25083743,5154757,"2020-12","2020"," LA","Morgan City","22101","St. Mary",77455806,8259400,13414157,102539549,4116492383,52,67,58,62,51,66
"886","2001","MORGAN CITY, LA",3677774639,17925044,4194193,"2021-12","2021"," LA","Morgan City","22101","St. Mary",117884493,19795115,23989308,135809537,3795659132,52,67,58,62,51,66
"887","2719","MORRO BAY, CA",459036,97744,18755,"2013-12","2013"," CA","Morro Bay","06079","San Luis Obispo",114881,24093,42848,212625,573917,160,135,131,129,123,127
"888","2719","MORRO BAY, CA",1700164,68675,24000,"2014-12","2014"," CA","Morro Bay","06079","San Luis Obispo",44146,3141,27141,112821,1744310,160,135,131,129,123,127
"889","2719","MORRO BAY, CA",3047789,0,0,"2015-12","2015"," CA","Morro Bay","06079","San Luis Obispo",172376,46062,46062,172376,3220165,160,135,131,129,123,127
"890","2719","MORRO BAY, CA",506778,69934,8530,"2016-12","2016"," CA","Morro Bay","06079","San Luis Obispo",431900,16101,24631,501834,938678,160,135,131,129,123,127
"891","2719","MORRO BAY, CA",1148178,9767,382,"2017-12","2017"," CA","Morro Bay","06079","San Luis Obispo",134456,26552,26934,144223,1282634,160,135,131,129,123,127
"892","2719","MORRO BAY, CA",398577,49800,51713,"2018-12","2018"," CA","Morro Bay","06079","San Luis Obispo",204121,18465,70178,253921,602698,160,135,131,129,123,127
"893","2719","MORRO BAY, CA",627734,13045,1317,"2019-12","2019"," CA","Morro Bay","06079","San Luis Obispo",92485,30542,31859,105530,720219,160,135,131,129,123,127
"894","2719","MORRO BAY, CA",5249054,0,0,"2020-12","2020"," CA","Morro Bay","06079","San Luis Obispo",0,0,0,0,5249054,160,135,131,129,123,127
"895","2719","MORRO BAY, CA",3455410,61785,6429,"2021-12","2021"," CA","Morro Bay","06079","San Luis Obispo",487985,93829,100258,549770,3943395,160,135,131,129,123,127
"896","3815","MUSKEGON, MI",471910,447220,43694,"2013-12","2013"," MI","Muskegon","26121","Muskegon",0,0,43694,447220,471910,173,128,111,118,114,114
"897","3815","MUSKEGON, MI",223463,212812,18500,"2014-12","2014"," MI","Muskegon","26121","Muskegon",168192,18212,36712,381004,391655,173,128,111,118,114,114
"898","3815","MUSKEGON, MI",875718,692052,106199,"2015-12","2015"," MI","Muskegon","26121","Muskegon",0,0,106199,692052,875718,173,128,111,118,114,114
"899","3815","MUSKEGON, MI",1137666,1084734,111079,"2016-12","2016"," MI","Muskegon","26121","Muskegon",0,0,111079,1084734,1137666,173,128,111,118,114,114
"900","3815","MUSKEGON, MI",612794,10000,2068,"2018-12","2018"," MI","Muskegon","26121","Muskegon",0,0,2068,10000,612794,173,128,111,118,114,114
"901","3815","MUSKEGON, MI",758962,0,0,"2019-12","2019"," MI","Muskegon","26121","Muskegon",1900878,388655,388655,1900878,2659840,173,128,111,118,114,114
"902","3815","MUSKEGON, MI",111469,94743,6810,"2020-12","2020"," MI","Muskegon","26121","Muskegon",5000,416,7226,99743,116469,173,128,111,118,114,114
"903","0405","NEW BEDFORD, MA",6664505,0,0,"2013-12","2013"," MA","New Bedford","25005","Bristol",1240544,804373,804373,1240544,7905049,143,101,110,116,81,85
"904","0405","NEW BEDFORD, MA",268926,117436,17730,"2014-12","2014"," MA","New Bedford","25005","Bristol",1500865,923347,941077,1618301,1769791,143,101,110,116,81,85
"905","0405","NEW BEDFORD, MA",358500,180800,8471,"2015-12","2015"," MA","New Bedford","25005","Bristol",10760409,6093077,6101548,10941209,11118909,143,101,110,116,81,85
"906","0405","NEW BEDFORD, MA",559157,559157,31404,"2016-12","2016"," MA","New Bedford","25005","Bristol",8334354,4747781,4779185,8893511,8893511,143,101,110,116,81,85
"907","0405","NEW BEDFORD, MA",12612284,663079,91726,"2017-12","2017"," MA","New Bedford","25005","Bristol",3367023,2288222,2379948,4030102,15979307,143,101,110,116,81,85
"908","0405","NEW BEDFORD, MA",410358,374667,38227,"2018-12","2018"," MA","New Bedford","25005","Bristol",28626227,1318403,1356630,29000894,29036585,143,101,110,116,81,85
"909","0405","NEW BEDFORD, MA",1740426,962477,57329,"2019-12","2019"," MA","New Bedford","25005","Bristol",988271,42175,99504,1950748,2728697,143,101,110,116,81,85
"910","0405","NEW BEDFORD, MA",361088,304250,83677,"2020-12","2020"," MA","New Bedford","25005","Bristol",188416,7580,91257,492666,549504,143,101,110,116,81,85
"911","0405","NEW BEDFORD, MA",2253922,277023,72975,"2021-12","2021"," MA","New Bedford","25005","Bristol",947760,2521753,2594728,1224783,3201682,143,101,110,116,81,85
"912","0412","NEW HAVEN, CT",148856757,0,0,"2013-12","2013"," CT","New Haven","09009","New Haven",29837,9100,9100,29837,148886594,106,63,93,75,69,54
"913","0412","NEW HAVEN, CT",53903126,51988,1228,"2014-12","2014"," CT","New Haven","09009","New Haven",6913490,9234897,9236125,6965478,60816616,106,63,93,75,69,54
"914","0412","NEW HAVEN, CT",32007361,0,0,"2015-12","2015"," CT","New Haven","09009","New Haven",13907988,69210108,69210108,13907988,45915349,106,63,93,75,69,54
"915","0412","NEW HAVEN, CT",43597361,44000,61195,"2016-12","2016"," CT","New Haven","09009","New Haven",18536467,16002321,16063516,18580467,62133828,106,63,93,75,69,54
"916","0412","NEW HAVEN, CT",71786924,10251805,36994653,"2017-12","2017"," CT","New Haven","09009","New Haven",11931491,23205500,60200153,22183296,83718415,106,63,93,75,69,54
"917","0412","NEW HAVEN, CT",66660702,6000,6359,"2018-12","2018"," CT","New Haven","09009","New Haven",8939996,10185512,10191871,8945996,75600698,106,63,93,75,69,54
"918","0412","NEW HAVEN, CT",66245669,142645,267076,"2019-12","2019"," CT","New Haven","09009","New Haven",8613975,62393875,62660951,8756620,74859644,106,63,93,75,69,54
"919","0412","NEW HAVEN, CT",114335349,52548,5977,"2020-12","2020"," CT","New Haven","09009","New Haven",7038977,130078085,130084062,7091525,121374326,106,63,93,75,69,54
"920","0412","NEW HAVEN, CT",204089367,0,0,"2021-12","2021"," CT","New Haven","09009","New Haven",50769779,65061773,65061773,50769779,254859146,106,63,93,75,69,54
"921","0413","NEW LONDON, CT",2429548,0,0,"2013-12","2013"," CT","New London","09011","New London",484963,613433,613433,484963,2914511,136,91,114,114,86,78
"922","0413","NEW LONDON, CT",124272,86047,54701,"2014-12","2014"," CT","New London","09011","New London",5833909,8348676,8403377,5919956,5958181,136,91,114,114,86,78
"923","0413","NEW LONDON, CT",185058,14046,340,"2015-12","2015"," CT","New London","09011","New London",4991199,4682537,4682877,5005245,5176257,136,91,114,114,86,78
"924","0413","NEW LONDON, CT",387057,290849,24119,"2016-12","2016"," CT","New London","09011","New London",1746001,3587292,3611411,2036850,2133058,136,91,114,114,86,78
"925","0413","NEW LONDON, CT",24000,24000,48000,"2017-12","2017"," CT","New London","09011","New London",4382830,4502531,4550531,4406830,4406830,136,91,114,114,86,78
"926","0413","NEW LONDON, CT",172517,128936,38817,"2018-12","2018"," CT","New London","09011","New London",13507743,19437799,19476616,13636679,13680260,136,91,114,114,86,78
"927","0413","NEW LONDON, CT",1040971,651322,51317,"2019-12","2019"," CT","New London","09011","New London",1938858,3992827,4044144,2590180,2979829,136,91,114,114,86,78
"928","0413","NEW LONDON, CT",97950756,981946,88660,"2020-12","2020"," CT","New London","09011","New London",0,0,88660,981946,97950756,136,91,114,114,86,78
"929","0413","NEW LONDON, CT",8324232,469347,117801,"2021-12","2021"," CT","New London","09011","New London",0,0,117801,469347,8324232,136,91,114,114,86,78
"930","2002","NEW ORLEANS, LA",62917958466,4652157060,2443395565,"2013-12","2013"," LA","New Orleans","22071","Orleans",5592405671,2766193859,5209589424,10244562731,68510364137,8,12,13,11,16,14
"931","2002","NEW ORLEANS, LA",63706237370,4866654823,2698386910,"2014-12","2014"," LA","New Orleans","22071","Orleans",5471952710,3686465109,6384852019,10338607533,69178190080,8,12,13,11,16,14
"932","2002","NEW ORLEANS, LA",56190287151,4859694625,3284210587,"2015-12","2015"," LA","New Orleans","22071","Orleans",5007804386,3398178195,6682388782,9867499011,61198091537,8,12,13,11,16,14
"933","2002","NEW ORLEANS, LA",57817910437,4925778211,3490178381,"2016-12","2016"," LA","New Orleans","22071","Orleans",4440151574,2871732619,6361911000,9365929785,62258062011,8,12,13,11,16,14
"934","2002","NEW ORLEANS, LA",62210253318,5780473025,3698308978,"2017-12","2017"," LA","New Orleans","22071","Orleans",4860467531,2669004616,6367313594,10640940556,67070720849,8,12,13,11,16,14
"935","2002","NEW ORLEANS, LA",67458030565,7416719689,4194185454,"2018-12","2018"," LA","New Orleans","22071","Orleans",5308161760,2667359295,6861544749,12724881449,72766192325,8,12,13,11,16,14
"936","2002","NEW ORLEANS, LA",68734829048,6541904174,4423079005,"2019-12","2019"," LA","New Orleans","22071","Orleans",5404523842,2715573082,7138652087,11946428016,74139352890,8,12,13,11,16,14
"937","2002","NEW ORLEANS, LA",65134667357,5970667522,4291947536,"2020-12","2020"," LA","New Orleans","22071","Orleans",4850886641,2485768476,6777716012,10821554163,69985553998,8,12,13,11,16,14
"938","2002","NEW ORLEANS, LA",80259365419,6843821434,3627798141,"2021-12","2021"," LA","New Orleans","22071","Orleans",5994399110,2719084442,6346882583,12838220544,86253764529,8,12,13,11,16,14
"939","1001","NEW YORK, NY",39475268981,28461456342,7308487395,"2013-12","2013"," NY","New York","36005","Bronx",8770503712,2322053104,9630540499,37231960054,48245772693,14,8,3,5,12,15
"940","1001","NEW YORK, NY",39681435621,28521943095,7035876158,"2014-12","2014"," NY","New York","36005","Bronx",9827044248,2609450564,9645326722,38348987343,49508479869,14,8,3,5,12,15
"941","1001","NEW YORK, NY",37319504685,27377435866,7152029658,"2015-12","2015"," NY","New York","36005","Bronx",8831245810,2618290413,9770320071,36208681676,46150750495,14,8,3,5,12,15
"942","1001","NEW YORK, NY",32145016682,25225942602,7803891180,"2016-12","2016"," NY","New York","36005","Bronx",7953745645,2159018770,9962909950,33179688247,40098762327,14,8,3,5,12,15
"943","1001","NEW YORK, NY",32136561087,27199625983,8707627431,"2017-12","2017"," NY","New York","36005","Bronx",8539132522,2272021479,10979648910,35738758505,40675693609,14,8,3,5,12,15
"944","1001","NEW YORK, NY",34058419201,30872764177,10367027383,"2018-12","2018"," NY","New York","36005","Bronx",8518754321,2466980742,12834008125,39391518498,42577173522,14,8,3,5,12,15
"945","1001","NEW YORK, NY",32254872403,29561070061,10121467941,"2019-12","2019"," NY","New York","36005","Bronx",9637242592,2878043571,12999511512,39198312653,41892114995,14,8,3,5,12,15
"946","1001","NEW YORK, NY",29510958965,27539210664,9429875690,"2020-12","2020"," NY","New York","36005","Bronx",8449486912,2449114764,11878990454,35988697576,37960445877,14,8,3,5,12,15
"947","1001","NEW YORK, NY",31063780024,29303376820,9750414192,"2021-12","2021"," NY","New York","36005","Bronx",12857638871,3614011822,13364426014,42161015691,43921418895,14,8,3,5,12,15
"948","2902","NEWPORT, OR",15839624,10583345,3685580,"2013-12","2013"," OR","Newport","41041","Lincoln",0,0,3685580,10583345,15839624,156,112,90,94,147,147
"949","2902","NEWPORT, OR",10979095,0,0,"2014-12","2014"," OR","Newport","41041","Lincoln",4413,1724,1724,4413,10983508,156,112,90,94,147,147
"950","2902","NEWPORT, OR",3053434,0,0,"2015-12","2015"," OR","Newport","41041","Lincoln",15236,632,632,15236,3068670,156,112,90,94,147,147
"951","2902","NEWPORT, OR",129479,0,0,"2016-12","2016"," OR","Newport","41041","Lincoln",0,0,0,0,129479,156,112,90,94,147,147
"952","2902","NEWPORT, OR",29180,0,0,"2017-12","2017"," OR","Newport","41041","Lincoln",0,0,0,0,29180,156,112,90,94,147,147
"953","2902","NEWPORT, OR",3245887,19219,7204,"2018-12","2018"," OR","Newport","41041","Lincoln",0,0,7204,19219,3245887,156,112,90,94,147,147
"954","2902","NEWPORT, OR",77912,31865,5054,"2019-12","2019"," OR","Newport","41041","Lincoln",27021,1591,6645,58886,104933,156,112,90,94,147,147
"955","2902","NEWPORT, OR",107668,107668,92380,"2021-12","2021"," OR","Newport","41041","Lincoln",11458,10025,102405,119126,119126,156,112,90,94,147,147
"956","0501","NEWPORT, RI",7697745,287633,62159,"2013-12","2013"," RI","Newport","44005","Newport",39705,18720,80879,327338,7737450,135,118,98,115,100,98
"957","0501","NEWPORT, RI",10560349,252800,4574,"2014-12","2014"," RI","Newport","44005","Newport",354423,6091,10665,607223,10914772,135,118,98,115,100,98
"958","0501","NEWPORT, RI",25792657,791433,69904,"2015-12","2015"," RI","Newport","44005","Newport",106500,60600,130504,897933,25899157,135,118,98,115,100,98
"959","0501","NEWPORT, RI",8260827,49804,2973,"2016-12","2016"," RI","Newport","44005","Newport",70874,14184,17157,120678,8331701,135,118,98,115,100,98
"960","0501","NEWPORT, RI",39375716,4993685,115493,"2017-12","2017"," RI","Newport","44005","Newport",0,0,115493,4993685,39375716,135,118,98,115,100,98
"961","0501","NEWPORT, RI",17851709,640399,91915,"2018-12","2018"," RI","Newport","44005","Newport",56704,31872,123787,697103,17908413,135,118,98,115,100,98
"962","0501","NEWPORT, RI",19599106,0,0,"2019-12","2019"," RI","Newport","44005","Newport",3476444,44891,44891,3476444,23075550,135,118,98,115,100,98
"963","0501","NEWPORT, RI",2166596,185200,49500,"2020-12","2020"," RI","Newport","44005","Newport",1660899,379492,428992,1846099,3827495,135,118,98,115,100,98
"964","0501","NEWPORT, RI",4640751,509216,27164,"2021-12","2021"," RI","Newport","44005","Newport",3517592,1566694,1593858,4026808,8158343,135,118,98,115,100,98
"965","1401","NORFOLK-NEWPORT NEWS, VA",29714654686,19992031716,6894729729,"2013-12","2013"," VA","Norfolk-Newport News","51811","Virginia Beach",34884957265,7060091465,13954821194,54876988981,64599611951,7,5,5,6,4,5
"966","1401","NORFOLK-NEWPORT NEWS, VA",30691040886,21685205569,7268178524,"2014-12","2014"," VA","Norfolk-Newport News","51811","Virginia Beach",38818363861,7668399704,14936578228,60503569430,69509404747,7,5,5,6,4,5
"967","1401","NORFOLK-NEWPORT NEWS, VA",28668887188,20324376900,7214047229,"2015-12","2015"," VA","Norfolk-Newport News","51811","Virginia Beach",41022588625,8297830130,15511877359,61346965525,69691475813,7,5,5,6,4,5
"968","1401","NORFOLK-NEWPORT NEWS, VA",25985867136,18770167581,7644441594,"2016-12","2016"," VA","Norfolk-Newport News","51811","Virginia Beach",42331571367,8901737241,16546178835,61101738948,68317438503,7,5,5,6,4,5
"969","1401","NORFOLK-NEWPORT NEWS, VA",27004027667,21339673966,9723725706,"2017-12","2017"," VA","Norfolk-Newport News","51811","Virginia Beach",44340884358,9523225809,19246951515,65680558324,71344912025,7,5,5,6,4,5
"970","1401","NORFOLK-NEWPORT NEWS, VA",24572575421,21554140996,10705745075,"2018-12","2018"," VA","Norfolk-Newport News","51811","Virginia Beach",47215875870,9701913964,20407659039,68770016866,71788451291,7,5,5,6,4,5
"971","1401","NORFOLK-NEWPORT NEWS, VA",24743332996,22394348617,8704358523,"2019-12","2019"," VA","Norfolk-Newport News","51811","Virginia Beach",48302644641,9676958778,18381317301,70696993258,73045977637,7,5,5,6,4,5
"972","1401","NORFOLK-NEWPORT NEWS, VA",24401590069,21666766636,8934888600,"2020-12","2020"," VA","Norfolk-Newport News","51811","Virginia Beach",43108273914,8967398741,17902287341,64775040550,67509863983,7,5,5,6,4,5
"973","1401","NORFOLK-NEWPORT NEWS, VA",30601520376,27419179781,10228598037,"2021-12","2021"," VA","Norfolk-Newport News","51811","Virginia Beach",58564158717,11807371054,22035969091,85983338498,89165679093,7,5,5,6,4,5
"974","2811","OAKLAND, CA",20142461443,14576710981,6586432990,"2013-12","2013"," CA","Oakland","06001","Alameda",25882658654,5838693888,12425126878,40459369635,46025120097,10,6,7,7,8,7
"975","2811","OAKLAND, CA",21029156647,15574372469,6419125635,"2014-12","2014"," CA","Oakland","06001","Alameda",27323758429,6268049524,12687175159,42898130898,48352915076,10,6,7,7,8,7
"976","2811","OAKLAND, CA",17917622230,13716971578,5933642904,"2015-12","2015"," CA","Oakland","06001","Alameda",25519789506,6260317428,12193960332,39236761084,43437411736,10,6,7,7,8,7
"977","2811","OAKLAND, CA",18740950242,14984555849,7115549643,"2016-12","2016"," CA","Oakland","06001","Alameda",25923555507,6402661503,13518211146,40908111356,44664505749,10,6,7,7,8,7
"978","2811","OAKLAND, CA",19619527690,15768923868,7424392223,"2017-12","2017"," CA","Oakland","06001","Alameda",26141539628,6595520345,14019912568,41910463496,45761067318,10,6,7,7,8,7
"979","2811","OAKLAND, CA",19864369486,17258527965,7787370440,"2018-12","2018"," CA","Oakland","06001","Alameda",27963132785,6669922747,14457293187,45221660750,47827502271,10,6,7,7,8,7
"980","2811","OAKLAND, CA",20258777928,18136677476,8106436456,"2019-12","2019"," CA","Oakland","06001","Alameda",28964097395,6780989393,14887425849,47100774871,49222875323,10,6,7,7,8,7
"981","2811","OAKLAND, CA",20627065754,18945484623,8409228867,"2020-12","2020"," CA","Oakland","06001","Alameda",28157047096,6861276535,15270505402,47102531719,48784112850,10,6,7,7,8,7
"982","2811","OAKLAND, CA",20763575122,19103620133,7914544050,"2021-12","2021"," CA","Oakland","06001","Alameda",27473582783,7217423549,15131967599,46577202916,48237157905,10,6,7,7,8,7
"983","0701","OGDENSBURG, NY",431373737,0,0,"2013-12","2013"," NY","Ogdensburg","36089","St. Lawrence",988153,1318890,1318890,988153,432361890,80,111,168,168,90,94
"984","0701","OGDENSBURG, NY",353264556,0,0,"2014-12","2014"," NY","Ogdensburg","36089","St. Lawrence",92021,130530,130530,92021,353356577,80,111,168,168,90,94
"985","0701","OGDENSBURG, NY",300993663,0,0,"2015-12","2015"," NY","Ogdensburg","36089","St. Lawrence",94664,24304,24304,94664,301088327,80,111,168,168,90,94
"986","0701","OGDENSBURG, NY",421914188,0,0,"2016-12","2016"," NY","Ogdensburg","36089","St. Lawrence",14393088,2498885,2498885,14393088,436307276,80,111,168,168,90,94
"987","0701","OGDENSBURG, NY",551673971,0,0,"2017-12","2017"," NY","Ogdensburg","36089","St. Lawrence",627544,203359,203359,627544,552301515,80,111,168,168,90,94
"988","0701","OGDENSBURG, NY",660081759,0,0,"2018-12","2018"," NY","Ogdensburg","36089","St. Lawrence",3389112,322243,322243,3389112,663470871,80,111,168,168,90,94
"989","0701","OGDENSBURG, NY",646956345,0,0,"2019-12","2019"," NY","Ogdensburg","36089","St. Lawrence",78501,23297,23297,78501,647034846,80,111,168,168,90,94
"990","0701","OGDENSBURG, NY",496840237,0,0,"2020-12","2020"," NY","Ogdensburg","36089","St. Lawrence",175625,98069,98069,175625,497015862,80,111,168,168,90,94
"991","0701","OGDENSBURG, NY",547087144,0,0,"2021-12","2021"," NY","Ogdensburg","36089","St. Lawrence",0,0,0,0,547087144,80,111,168,168,90,94
"992","3026","OLYMPIA, WA",126146893,460028,1072859,"2013-12","2013"," WA","Olympia","53067","Thurston",0,0,1072859,460028,126146893,103,94,94,76,125,135
"993","3026","OLYMPIA, WA",124251809,1686292,6858172,"2014-12","2014"," WA","Olympia","53067","Thurston",99647,25382,6883554,1785939,124351456,103,94,94,76,125,135
"994","3026","OLYMPIA, WA",93835500,27373,2386,"2015-12","2015"," WA","Olympia","53067","Thurston",172179,3300,5686,199552,94007679,103,94,94,76,125,135
"995","3026","OLYMPIA, WA",115547264,2269788,12143964,"2016-12","2016"," WA","Olympia","53067","Thurston",236500,65404,12209368,2506288,115783764,103,94,94,76,125,135
"996","3026","OLYMPIA, WA",117604006,1811787,9014500,"2017-12","2017"," WA","Olympia","53067","Thurston",0,0,9014500,1811787,117604006,103,94,94,76,125,135
"997","3026","OLYMPIA, WA",122761047,689589,2880509,"2018-12","2018"," WA","Olympia","53067","Thurston",0,0,2880509,689589,122761047,103,94,94,76,125,135
"998","3026","OLYMPIA, WA",98089471,0,0,"2019-12","2019"," WA","Olympia","53067","Thurston",1066356,32350,32350,1066356,99155827,103,94,94,76,125,135
"999","3026","OLYMPIA, WA",114636139,3414200,2639900,"2020-12","2020"," WA","Olympia","53067","Thurston",3000,440,2640340,3417200,114639139,103,94,94,76,125,135
"1000","3026","OLYMPIA, WA",177549437,0,0,"2021-12","2021"," WA","Olympia","53067","Thurston",3000,436,436,3000,177552437,103,94,94,76,125,135
"1001","2103","ORANGE, TX",2937729,0,0,"2013-12","2013"," TX","Orange","48361","Orange",0,0,0,0,2937729,125,109,80,92,132,140
"1002","2103","ORANGE, TX",73360,10206,1065,"2014-12","2014"," TX","Orange","48361","Orange",0,0,1065,10206,73360,125,109,80,92,132,140
"1003","2103","ORANGE, TX",90026871,25837241,4712396,"2015-12","2015"," TX","Orange","48361","Orange",0,0,4712396,25837241,90026871,125,109,80,92,132,140
"1004","2103","ORANGE, TX",60642,44067,20283,"2016-12","2016"," TX","Orange","48361","Orange",0,0,20283,44067,60642,125,109,80,92,132,140
"1005","2103","ORANGE, TX",90431,90431,30953,"2017-12","2017"," TX","Orange","48361","Orange",0,0,30953,90431,90431,125,109,80,92,132,140
"1006","2103","ORANGE, TX",59170272,375841,19441,"2018-12","2018"," TX","Orange","48361","Orange",855889,26639,46080,1231730,60026161,125,109,80,92,132,140
"1007","2103","ORANGE, TX",44525909,135113,86650,"2019-12","2019"," TX","Orange","48361","Orange",0,0,86650,135113,44525909,125,109,80,92,132,140
"1008","2103","ORANGE, TX",36495,0,0,"2021-12","2021"," TX","Orange","48361","Orange",44062,16097,16097,44062,80557,125,109,80,92,132,140
"1009","1808","ORLANDO, FL",1060133609,0,0,"2013-12","2013"," FL","Orlando","12097","Osceola",0,0,0,0,1060133609,61,172.5,168,168,170,170
"1010","1808","ORLANDO, FL",1074759386,0,0,"2014-12","2014"," FL","Orlando","12097","Osceola",0,0,0,0,1074759386,61,172.5,168,168,170,170
"1011","1808","ORLANDO, FL",2074866952,0,0,"2015-12","2015"," FL","Orlando","12097","Osceola",0,0,0,0,2074866952,61,172.5,168,168,170,170
"1012","1808","ORLANDO, FL",2295522116,0,0,"2016-12","2016"," FL","Orlando","12097","Osceola",0,0,0,0,2295522116,61,172.5,168,168,170,170
"1013","1808","ORLANDO, FL",1756343276,0,0,"2017-12","2017"," FL","Orlando","12097","Osceola",0,0,0,0,1756343276,61,172.5,168,168,170,170
"1014","1808","ORLANDO, FL",2180155519,0,0,"2018-12","2018"," FL","Orlando","12097","Osceola",0,0,0,0,2180155519,61,172.5,168,168,170,170
"1015","1808","ORLANDO, FL",2042522915,0,0,"2019-12","2019"," FL","Orlando","12097","Osceola",0,0,0,0,2042522915,61,172.5,168,168,170,170
"1016","1808","ORLANDO, FL",964407080,0,0,"2020-12","2020"," FL","Orlando","12097","Osceola",0,0,0,0,964407080,61,172.5,168,168,170,170
"1017","1808","ORLANDO, FL",257458749,0,0,"2021-12","2021"," FL","Orlando","12097","Osceola",0,0,0,0,257458749,61,172.5,168,168,170,170
"1018","0904","OSWEGO, NY",1764539,0,0,"2013-12","2013"," NY","Oswego","36075","Oswego",37036552,80418908,80418908,37036552,38801091,137,73,118,141,72,68
"1019","0904","OSWEGO, NY",2354004,0,0,"2014-12","2014"," NY","Oswego","36075","Oswego",38059405,21080886,21080886,38059405,40413409,137,73,118,141,72,68
"1020","0904","OSWEGO, NY",2046040,0,0,"2015-12","2015"," NY","Oswego","36075","Oswego",7057206,3486247,3486247,7057206,9103246,137,73,118,141,72,68
"1021","0904","OSWEGO, NY",908361,0,0,"2016-12","2016"," NY","Oswego","36075","Oswego",3471099,8367912,8367912,3471099,4379460,137,73,118,141,72,68
"1022","0904","OSWEGO, NY",1253133,0,0,"2017-12","2017"," NY","Oswego","36075","Oswego",475017,7062300,7062300,475017,1728150,137,73,118,141,72,68
"1023","0904","OSWEGO, NY",3122370,1847672,39952,"2018-12","2018"," NY","Oswego","36075","Oswego",6367982,2570852,2610804,8215654,9490352,137,73,118,141,72,68
"1024","0904","OSWEGO, NY",7370739,0,0,"2019-12","2019"," NY","Oswego","36075","Oswego",3780692,3674522,3674522,3780692,11151431,137,73,118,141,72,68
"1025","0904","OSWEGO, NY",1903340,0,0,"2020-12","2020"," NY","Oswego","36075","Oswego",8197657,7120458,7120458,8197657,10100997,137,73,118,141,72,68
"1026","0904","OSWEGO, NY",3172628,0,0,"2021-12","2021"," NY","Oswego","36075","Oswego",6766366,2498243,2498243,6766366,9938994,137,73,118,141,72,68
"1027","1818","PANAMA CITY, FL",721003989,331316915,138213256,"2013-12","2013"," FL","Panama City","12005","Bay",1095252484,179963163,318176419,1426569399,1816256473,65,46,34,44,30,45
"1028","1818","PANAMA CITY, FL",830904102,291419434,113854479,"2014-12","2014"," FL","Panama City","12005","Bay",710912442,125133734,238988213,1002331876,1541816544,65,46,34,44,30,45
"1029","1818","PANAMA CITY, FL",570633311,237024005,77910844,"2015-12","2015"," FL","Panama City","12005","Bay",657267002,116012659,193923503,894291007,1227900313,65,46,34,44,30,45
"1030","1818","PANAMA CITY, FL",497543028,209127830,71395149,"2016-12","2016"," FL","Panama City","12005","Bay",494524671,100592849,171987998,703652501,992067699,65,46,34,44,30,45
"1031","1818","PANAMA CITY, FL",647692812,342313781,76389584,"2017-12","2017"," FL","Panama City","12005","Bay",452011281,100191137,176580721,794325062,1099704093,65,46,34,44,30,45
"1032","1818","PANAMA CITY, FL",471976664,207203323,66933568,"2018-12","2018"," FL","Panama City","12005","Bay",548083261,115979720,182913288,755286584,1020059925,65,46,34,44,30,45
"1033","1818","PANAMA CITY, FL",482679416,173720632,43818329,"2019-12","2019"," FL","Panama City","12005","Bay",492878210,114890360,158708689,666598842,975557626,65,46,34,44,30,45
"1034","1818","PANAMA CITY, FL",385060758,129404914,49546981,"2020-12","2020"," FL","Panama City","12005","Bay",474243816,113791931,163338912,603648730,859304574,65,46,34,44,30,45
"1035","1818","PANAMA CITY, FL",546919681,184437639,72199712,"2021-12","2021"," FL","Panama City","12005","Bay",586332133,129426989,201626701,770769772,1133251814,65,46,34,44,30,45
"1036","1903","PASCAGOULA, MS",4784940876,50071149,90970371,"2013-12","2013"," MS","Pascagoula","28059","Jackson",275308,96097,91066468,50346457,4785216184,47,42,31,26,71,90
"1037","1903","PASCAGOULA, MS",4192532297,89781163,119162037,"2014-12","2014"," MS","Pascagoula","28059","Jackson",2347009,130238,119292275,92128172,4194879306,47,42,31,26,71,90
"1038","1903","PASCAGOULA, MS",3573837875,179183592,303013749,"2015-12","2015"," MS","Pascagoula","28059","Jackson",269193,45907,303059656,179452785,3574107068,47,42,31,26,71,90
"1039","1903","PASCAGOULA, MS",3025082965,229427726,400089454,"2016-12","2016"," MS","Pascagoula","28059","Jackson",81141874,1246216,401335670,310569600,3106224839,47,42,31,26,71,90
"1040","1903","PASCAGOULA, MS",3011662484,381657825,540837240,"2017-12","2017"," MS","Pascagoula","28059","Jackson",590618,181540,541018780,382248443,3012253102,47,42,31,26,71,90
"1041","1903","PASCAGOULA, MS",3161209747,377773175,491181876,"2018-12","2018"," MS","Pascagoula","28059","Jackson",12067817,5512991,496694867,389840992,3173277564,47,42,31,26,71,90
"1042","1903","PASCAGOULA, MS",3003945126,339560534,484634111,"2019-12","2019"," MS","Pascagoula","28059","Jackson",20100450,2696544,487330655,359660984,3024045576,47,42,31,26,71,90
"1043","1903","PASCAGOULA, MS",2156420272,257593067,365350101,"2020-12","2020"," MS","Pascagoula","28059","Jackson",440247,64740,365414841,258033314,2156860519,47,42,31,26,71,90
"1044","1903","PASCAGOULA, MS",3485249978,566678093,581796315,"2021-12","2021"," MS","Pascagoula","28059","Jackson",2055350,499969,582296284,568733443,3487305328,47,42,31,26,71,90
"1045","1105","PAULSBORO, NJ",885979872,200079,75547,"2013-12","2013"," NJ","Paulsboro","42045","Delaware",0,0,75547,200079,885979872,85,105,97,87,140,131
"1046","1105","PAULSBORO, NJ",620798735,120961,28542,"2014-12","2014"," NJ","Paulsboro","42045","Delaware",103765,64406,92948,224726,620902500,85,105,97,87,140,131
"1047","1105","PAULSBORO, NJ",259123986,32541,23757,"2015-12","2015"," NJ","Paulsboro","42045","Delaware",50241,10029,33786,82782,259174227,85,105,97,87,140,131
"1048","1105","PAULSBORO, NJ",187932377,3817076,4021108,"2016-12","2016"," NJ","Paulsboro","42045","Delaware",0,0,4021108,3817076,187932377,85,105,97,87,140,131
"1049","1105","PAULSBORO, NJ",32863187,114151,179842,"2017-12","2017"," NJ","Paulsboro","42045","Delaware",109362,14167,194009,223513,32972549,85,105,97,87,140,131
"1050","1819","PENSACOLA, FL",219922496,186510,207184,"2013-12","2013"," FL","Pensacola","12113","Santa Rosa",2048080,658074,865258,2234590,221970576,98,88,81,77,74,84
"1051","1819","PENSACOLA, FL",487150826,347997,484136,"2014-12","2014"," FL","Pensacola","12113","Santa Rosa",4716889,2050035,2534171,5064886,491867715,98,88,81,77,74,84
"1052","1819","PENSACOLA, FL",373946153,485269,116824,"2015-12","2015"," FL","Pensacola","12113","Santa Rosa",8628303,274576,391400,9113572,382574456,98,88,81,77,74,84
"1053","1819","PENSACOLA, FL",38382484,384124,169633,"2016-12","2016"," FL","Pensacola","12113","Santa Rosa",0,0,169633,384124,38382484,98,88,81,77,74,84
"1054","1819","PENSACOLA, FL",12432503,0,0,"2017-12","2017"," FL","Pensacola","12113","Santa Rosa",10037,45970,45970,10037,12442540,98,88,81,77,74,84
"1055","1819","PENSACOLA, FL",30872795,17470067,22819989,"2018-12","2018"," FL","Pensacola","12113","Santa Rosa",6681030,4429580,27249569,24151097,37553825,98,88,81,77,74,84
"1056","1819","PENSACOLA, FL",6679783,4877364,6249267,"2019-12","2019"," FL","Pensacola","12113","Santa Rosa",3491778,1433111,7682378,8369142,10171561,98,88,81,77,74,84
"1057","1819","PENSACOLA, FL",5560869,1197800,357311,"2020-12","2020"," FL","Pensacola","12113","Santa Rosa",19092075,2827920,3185231,20289875,24652944,98,88,81,77,74,84
"1058","1819","PENSACOLA, FL",13786044,1483158,457895,"2021-12","2021"," FL","Pensacola","12113","Santa Rosa",42180983,7884409,8342304,43664141,55967027,98,88,81,77,74,84
"1059","3902","PEORIA, IL",5918130,0,0,"2013-12","2013"," IL","Peoria","17143","Peoria",106918,21660,21660,106918,6025048,148,124,150,131,85,104
"1060","3902","PEORIA, IL",1345739,0,0,"2014-12","2014"," IL","Peoria","17143","Peoria",7010813,80236,80236,7010813,8356552,148,124,150,131,85,104
"1061","3902","PEORIA, IL",5423531,16597,1e+05,"2015-12","2015"," IL","Peoria","17143","Peoria",863810,143467,243467,880407,6287341,148,124,150,131,85,104
"1062","3902","PEORIA, IL",1265545,0,0,"2016-12","2016"," IL","Peoria","17143","Peoria",891815,144439,144439,891815,2157360,148,124,150,131,85,104
"1063","3902","PEORIA, IL",13220644,0,0,"2017-12","2017"," IL","Peoria","17143","Peoria",18457228,107122,107122,18457228,31677872,148,124,150,131,85,104
"1064","3902","PEORIA, IL",1831642,0,0,"2018-12","2018"," IL","Peoria","17143","Peoria",4574262,275550,275550,4574262,6405904,148,124,150,131,85,104
"1065","3902","PEORIA, IL",332167,0,0,"2019-12","2019"," IL","Peoria","17143","Peoria",936184,102891,102891,936184,1268351,148,124,150,131,85,104
"1066","3902","PEORIA, IL",743264,0,0,"2020-12","2020"," IL","Peoria","17143","Peoria",107533,63515,63515,107533,850797,148,124,150,131,85,104
"1067","3902","PEORIA, IL",1355346,0,0,"2021-12","2021"," IL","Peoria","17143","Peoria",1914350,191372,191372,1914350,3269696,148,124,150,131,85,104
"1068","1101","PHILADELPHIA, PA",5162378689,1462716733,346109608,"2013-12","2013"," PA","Philadelphia","42017","Bucks",5656605768,2216820543,2562930151,7119322501,10818984457,26,15,17,24,13,12
"1069","1101","PHILADELPHIA, PA",5310650425,1765606520,476514549,"2014-12","2014"," PA","Philadelphia","42017","Bucks",7612584326,2581445918,3057960467,9378190846,12923234751,26,15,17,24,13,12
"1070","1101","PHILADELPHIA, PA",4254349505,1858402672,576800081,"2015-12","2015"," PA","Philadelphia","42017","Bucks",8269508319,2998434641,3575234722,10127910991,12523857824,26,15,17,24,13,12
"1071","1101","PHILADELPHIA, PA",4264203093,1653203904,481089519,"2016-12","2016"," PA","Philadelphia","42017","Bucks",7543926716,3099834603,3580924122,9197130620,11808129809,26,15,17,24,13,12
"1072","1101","PHILADELPHIA, PA",5283100948,2398772864,577350257,"2017-12","2017"," PA","Philadelphia","42017","Bucks",8583882452,3208772405,3786122662,10982655316,13866983400,26,15,17,24,13,12
"1073","1101","PHILADELPHIA, PA",4637314087,2483962665,535312476,"2018-12","2018"," PA","Philadelphia","42017","Bucks",9640383509,3201888231,3737200707,12124346174,14277697596,26,15,17,24,13,12
"1074","1101","PHILADELPHIA, PA",4850678558,2359678373,496989675,"2019-12","2019"," PA","Philadelphia","42017","Bucks",10249824023,3317137052,3814126727,12609502396,15100502581,26,15,17,24,13,12
"1075","1101","PHILADELPHIA, PA",4044206706,2104071667,479091230,"2020-12","2020"," PA","Philadelphia","42017","Bucks",11642867043,3496026270,3975117500,13746938710,15687073749,26,15,17,24,13,12
"1076","1101","PHILADELPHIA, PA",5433087422,2616482021,669229322,"2021-12","2021"," PA","Philadelphia","42017","Bucks",13123612681,4305581290,4974810612,15740094702,18556700103,26,15,17,24,13,12
"1077","1104","PITTSBURGH, PA",59017696,0,0,"2013-12","2013"," PA","Pittsburgh","42003","Allegheny",0,0,0,0,59017696,107,172.5,168,168,170,170
"1078","1104","PITTSBURGH, PA",61374363,0,0,"2014-12","2014"," PA","Pittsburgh","42003","Allegheny",0,0,0,0,61374363,107,172.5,168,168,170,170
"1079","1104","PITTSBURGH, PA",54434621,0,0,"2015-12","2015"," PA","Pittsburgh","42003","Allegheny",0,0,0,0,54434621,107,172.5,168,168,170,170
"1080","1104","PITTSBURGH, PA",64937714,0,0,"2016-12","2016"," PA","Pittsburgh","42003","Allegheny",0,0,0,0,64937714,107,172.5,168,168,170,170
"1081","1104","PITTSBURGH, PA",166647998,0,0,"2017-12","2017"," PA","Pittsburgh","42003","Allegheny",0,0,0,0,166647998,107,172.5,168,168,170,170
"1082","1104","PITTSBURGH, PA",121904706,0,0,"2018-12","2018"," PA","Pittsburgh","42003","Allegheny",0,0,0,0,121904706,107,172.5,168,168,170,170
"1083","1104","PITTSBURGH, PA",177103422,0,0,"2019-12","2019"," PA","Pittsburgh","42003","Allegheny",0,0,0,0,177103422,107,172.5,168,168,170,170
"1084","1104","PITTSBURGH, PA",97366125,0,0,"2020-12","2020"," PA","Pittsburgh","42003","Allegheny",0,0,0,0,97366125,107,172.5,168,168,170,170
"1085","1104","PITTSBURGH, PA",117596173,0,0,"2021-12","2021"," PA","Pittsburgh","42003","Allegheny",0,0,0,0,117596173,107,172.5,168,168,170,170
"1086","0406","PLYMOUTH, MA",71119,0,0,"2013-12","2013"," MA","Plymouth","25023","Plymouth",33537,3600,3600,33537,104656,175,114,121,103,113,102
"1087","0406","PLYMOUTH, MA",1379522,4291,60,"2014-12","2014"," MA","Plymouth","25023","Plymouth",218900,4148,4208,223191,1598422,175,114,121,103,113,102
"1088","0406","PLYMOUTH, MA",758402,0,0,"2015-12","2015"," MA","Plymouth","25023","Plymouth",115298,6334,6334,115298,873700,175,114,121,103,113,102
"1089","0406","PLYMOUTH, MA",1881994,1205643,1715863,"2016-12","2016"," MA","Plymouth","25023","Plymouth",1893624,1294955,3010818,3099267,3775618,175,114,121,103,113,102
"1090","0406","PLYMOUTH, MA",309424,296266,444816,"2017-12","2017"," MA","Plymouth","25023","Plymouth",0,0,444816,296266,309424,175,114,121,103,113,102
"1091","0406","PLYMOUTH, MA",84621,84621,5107,"2018-12","2018"," MA","Plymouth","25023","Plymouth",387152,27675,32782,471773,471773,175,114,121,103,113,102
"1092","0406","PLYMOUTH, MA",149169,0,0,"2019-12","2019"," MA","Plymouth","25023","Plymouth",43078,14568,14568,43078,192247,175,114,121,103,113,102
"1093","0406","PLYMOUTH, MA",75502,0,0,"2020-12","2020"," MA","Plymouth","25023","Plymouth",8000,194,194,8000,83502,175,114,121,103,113,102
"1094","0406","PLYMOUTH, MA",75978,7780,3777,"2021-12","2021"," MA","Plymouth","25023","Plymouth",11288,1453,5230,19068,87266,175,114,121,103,113,102
"1095","3007","PORT ANGELES, WA",162394008,0,0,"2013-12","2013"," WA","Port Angeles","53009","Clallam",60320,18613,18613,60320,162454328,101,133,132,124,119,120
"1096","3007","PORT ANGELES, WA",109911099,109343,195710,"2014-12","2014"," WA","Port Angeles","53009","Clallam",39494,2417,198127,148837,109950593,101,133,132,124,119,120
"1097","3007","PORT ANGELES, WA",526595436,186979,2368,"2015-12","2015"," WA","Port Angeles","53009","Clallam",89654,20610,22978,276633,526685090,101,133,132,124,119,120
"1098","3007","PORT ANGELES, WA",65166437,69207,22814,"2016-12","2016"," WA","Port Angeles","53009","Clallam",261276,34223,57037,330483,65427713,101,133,132,124,119,120
"1099","3007","PORT ANGELES, WA",104378526,0,0,"2017-12","2017"," WA","Port Angeles","53009","Clallam",39850,11909,11909,39850,104418376,101,133,132,124,119,120
"1100","3007","PORT ANGELES, WA",88805694,0,0,"2018-12","2018"," WA","Port Angeles","53009","Clallam",94490,11550,11550,94490,88900184,101,133,132,124,119,120
"1101","3007","PORT ANGELES, WA",45836543,0,0,"2019-12","2019"," WA","Port Angeles","53009","Clallam",29054,20604,20604,29054,45865597,101,133,132,124,119,120
"1102","3007","PORT ANGELES, WA",23497597,0,0,"2020-12","2020"," WA","Port Angeles","53009","Clallam",198374,33150,33150,198374,23695971,101,133,132,124,119,120
"1103","3007","PORT ANGELES, WA",44725496,0,0,"2021-12","2021"," WA","Port Angeles","53009","Clallam",1149814,204780,204780,1149814,45875310,101,133,132,124,119,120
"1104","2101","PORT ARTHUR, TX",8157332005,120503414,219050222,"2013-12","2013"," TX","Port Arthur","22023","Cameron",96195008,161281865,380332087,216698422,8253527013,31,36,50,28,53,43
"1105","2101","PORT ARTHUR, TX",9384123876,62525190,189977391,"2014-12","2014"," TX","Port Arthur","22023","Cameron",201782624,291040733,481018124,264307814,9585906500,31,36,50,28,53,43
"1106","2101","PORT ARTHUR, TX",6221767503,39033906,139270579,"2015-12","2015"," TX","Port Arthur","22023","Cameron",151794698,258081310,397351889,190828604,6373562201,31,36,50,28,53,43
"1107","2101","PORT ARTHUR, TX",4754884225,22365164,60341226,"2016-12","2016"," TX","Port Arthur","22023","Cameron",18485936,104556312,164897538,40851100,4773370161,31,36,50,28,53,43
"1108","2101","PORT ARTHUR, TX",5678579254,25529315,48366907,"2017-12","2017"," TX","Port Arthur","22023","Cameron",81661201,6277282,54644189,107190516,5760240455,31,36,50,28,53,43
"1109","2101","PORT ARTHUR, TX",9506468941,14666296,24546609,"2018-12","2018"," TX","Port Arthur","22023","Cameron",9570394,20871420,45418029,24236690,9516039335,31,36,50,28,53,43
"1110","2101","PORT ARTHUR, TX",8921053717,59181638,717003240,"2019-12","2019"," TX","Port Arthur","22023","Cameron",29851769,34362209,751365449,89033407,8950905486,31,36,50,28,53,43
"1111","2101","PORT ARTHUR, TX",5242210565,118612231,1414206066,"2020-12","2020"," TX","Port Arthur","22023","Cameron",63222975,127522816,1541728882,181835206,5305433540,31,36,50,28,53,43
"1112","2101","PORT ARTHUR, TX",11226140732,200552507,341891981,"2021-12","2021"," TX","Port Arthur","22023","Cameron",80431082,109297687,451189668,280983589,11306571814,31,36,50,28,53,43
"1113","1816","PORT CANAVERAL, FL",144829492,544557,418396,"2013-12","2013"," FL","Port Canaveral","12009","Brevard",16946409,30792315,31210711,17490966,161775901,100,60,70,67,59,51
"1114","1816","PORT CANAVERAL, FL",52546405,611405,256194,"2014-12","2014"," FL","Port Canaveral","12009","Brevard",2606061,6447013,6703207,3217466,55152466,100,60,70,67,59,51
"1115","1816","PORT CANAVERAL, FL",51355887,759466,249376,"2015-12","2015"," FL","Port Canaveral","12009","Brevard",3525663,3179580,3428956,4285129,54881550,100,60,70,67,59,51
"1116","1816","PORT CANAVERAL, FL",59044059,17508673,19649093,"2016-12","2016"," FL","Port Canaveral","12009","Brevard",23699092,97852235,117501328,41207765,82743151,100,60,70,67,59,51
"1117","1816","PORT CANAVERAL, FL",68641061,22279245,30056554,"2017-12","2017"," FL","Port Canaveral","12009","Brevard",57474929,67634502,97691056,79754174,126115990,100,60,70,67,59,51
"1118","1816","PORT CANAVERAL, FL",34257176,7721941,2654371,"2018-12","2018"," FL","Port Canaveral","12009","Brevard",29897930,62215566,64869937,37619871,64155106,100,60,70,67,59,51
"1119","1816","PORT CANAVERAL, FL",50943101,4833147,225095,"2019-12","2019"," FL","Port Canaveral","12009","Brevard",26241778,67030684,67255779,31074925,77184879,100,60,70,67,59,51
"1120","1816","PORT CANAVERAL, FL",75027858,7321473,373743,"2020-12","2020"," FL","Port Canaveral","12009","Brevard",41904079,85312365,85686108,49225552,116931937,100,60,70,67,59,51
"1121","1816","PORT CANAVERAL, FL",393292534,10335629,11019511,"2021-12","2021"," FL","Port Canaveral","12009","Brevard",87878806,108948712,119968223,98214435,481171340,100,60,70,67,59,51
"1122","5203","PORT EVERGLADES, FL",13408169080,8084497634,1592262888,"2013-12","2013"," FL","Port Everglades","12011","Broward",7612420786,2442738970,4035001858,15696918420,21020589866,20,14,9,14,14,13
"1123","5203","PORT EVERGLADES, FL",13626978551,8609097122,1661907655,"2014-12","2014"," FL","Port Everglades","12011","Broward",9208428276,2851737041,4513644696,17817525398,22835406827,20,14,9,14,14,13
"1124","5203","PORT EVERGLADES, FL",13244271954,8739633262,2048092659,"2015-12","2015"," FL","Port Everglades","12011","Broward",8556182005,2901328525,4949421184,17295815267,21800453959,20,14,9,14,14,13
"1125","5203","PORT EVERGLADES, FL",11707711101,8986905429,1761986388,"2016-12","2016"," FL","Port Everglades","12011","Broward",8634037467,3135766140,4897752528,17620942896,20341748568,20,14,9,14,14,13
"1126","5203","PORT EVERGLADES, FL",12101687169,9861552003,1945513346,"2017-12","2017"," FL","Port Everglades","12011","Broward",9063629429,3125422701,5070936047,18925181432,21165316598,20,14,9,14,14,13
"1127","5203","PORT EVERGLADES, FL",12670738069,10365561357,2074775130,"2018-12","2018"," FL","Port Everglades","12011","Broward",9712108145,3237302973,5312078103,20077669502,22382846214,20,14,9,14,14,13
"1128","5203","PORT EVERGLADES, FL",12199694308,9964757355,1926969351,"2019-12","2019"," FL","Port Everglades","12011","Broward",8380274903,2915079205,4842048556,18345032258,20579969211,20,14,9,14,14,13
"1129","5203","PORT EVERGLADES, FL",9661129336,7884740945,1598050462,"2020-12","2020"," FL","Port Everglades","12011","Broward",7545614336,2686103915,4284154377,15430355281,17206743672,20,14,9,14,14,13
"1130","5203","PORT EVERGLADES, FL",11783301926,9956763744,2004790738,"2021-12","2021"," FL","Port Everglades","12011","Broward",10174562848,3347768201,5352558939,20131326592,21957864774,20,14,9,14,14,13
"1131","2713","PORT HUENEME, CA",826061811,88223803,37768178,"2013-12","2013"," CA","Port Hueneme","06111","Ventura",345421488,194164920,231933098,433645291,1171483299,58,29,30,41,26,25
"1132","2713","PORT HUENEME, CA",1149826254,411855524,66447450,"2014-12","2014"," CA","Port Hueneme","06111","Ventura",517196390,401584775,468032225,929051914,1667022644,58,29,30,41,26,25
"1133","2713","PORT HUENEME, CA",963074665,318944741,85598342,"2015-12","2015"," CA","Port Hueneme","06111","Ventura",647222988,501989523,587587865,966167729,1610297653,58,29,30,41,26,25
"1134","2713","PORT HUENEME, CA",1243679836,287727293,79909426,"2016-12","2016"," CA","Port Hueneme","06111","Ventura",457476763,430473079,510382505,745204056,1701156599,58,29,30,41,26,25
"1135","2713","PORT HUENEME, CA",883662264,351546268,86726516,"2017-12","2017"," CA","Port Hueneme","06111","Ventura",318905162,258497427,345223943,670451430,1202567426,58,29,30,41,26,25
"1136","2713","PORT HUENEME, CA",1113634233,187352236,90607075,"2018-12","2018"," CA","Port Hueneme","06111","Ventura",627389962,382695021,473302096,814742198,1741024195,58,29,30,41,26,25
"1137","2713","PORT HUENEME, CA",1216499552,260802560,123043340,"2019-12","2019"," CA","Port Hueneme","06111","Ventura",1024834279,647116051,770159391,1285636839,2241333831,58,29,30,41,26,25
"1138","2713","PORT HUENEME, CA",628088068,159968093,101106775,"2020-12","2020"," CA","Port Hueneme","06111","Ventura",1257832507,910843574,1011950349,1417800600,1885920575,58,29,30,41,26,25
"1139","2713","PORT HUENEME, CA",1244525551,742042147,219498352,"2021-12","2021"," CA","Port Hueneme","06111","Ventura",1844663559,1134778192,1354276544,2586705706,3089189110,58,29,30,41,26,25
"1140","3802","PORT HURON, MI",45535843459,412487149,62783348,"2013-12","2013"," MI","Port Huron","26147","St. Clair",84657137,11812722,74596070,497144286,45620500596,11,53,26,43,49,57
"1141","3802","PORT HURON, MI",48868145508,294723717,50231681,"2014-12","2014"," MI","Port Huron","26147","St. Clair",129209135,33171324,83403005,423932852,48997354643,11,53,26,43,49,57
"1142","3802","PORT HURON, MI",42936735644,306176013,56079641,"2015-12","2015"," MI","Port Huron","26147","St. Clair",125195695,35239194,91318835,431371708,43061931339,11,53,26,43,49,57
"1143","3802","PORT HURON, MI",42509477739,585874238,85495703,"2016-12","2016"," MI","Port Huron","26147","St. Clair",130882839,24814940,110310643,716757077,42640360578,11,53,26,43,49,57
"1144","3802","PORT HURON, MI",47324153002,644602474,112623389,"2017-12","2017"," MI","Port Huron","26147","St. Clair",111779243,65627842,178251231,756381717,47435932245,11,53,26,43,49,57
"1145","3802","PORT HURON, MI",50415811322,658020554,108078803,"2018-12","2018"," MI","Port Huron","26147","St. Clair",83409636,13595881,121674684,741430190,50499220958,11,53,26,43,49,57
"1146","3802","PORT HURON, MI",46543735348,596414967,97833777,"2019-12","2019"," MI","Port Huron","26147","St. Clair",101096283,43629629,141463406,697511250,46644831631,11,53,26,43,49,57
"1147","3802","PORT HURON, MI",39184271572,483061257,83134920,"2020-12","2020"," MI","Port Huron","26147","St. Clair",104163019,48592888,131727808,587224276,39288434591,11,53,26,43,49,57
"1148","3802","PORT HURON, MI",49169415455,579817154,99222879,"2021-12","2021"," MI","Port Huron","26147","St. Clair",130406496,44029529,143252408,710223650,49299821951,11,53,26,43,49,57
"1149","5313","PORT LAVACA, TX",836872581,46553149,115829262,"2013-12","2013"," TX","Port Lavaca","48057","Calhoun",257509306,333512719,449341981,304062455,1094381887,69,43,65,49,44,35
"1150","5313","PORT LAVACA, TX",819995620,19505158,93173554,"2014-12","2014"," TX","Port Lavaca","48057","Calhoun",216580544,285368099,378541653,236085702,1036576164,69,43,65,49,44,35
"1151","5313","PORT LAVACA, TX",668980485,16656115,89161100,"2015-12","2015"," TX","Port Lavaca","48057","Calhoun",171648196,306289902,395451002,188304311,840628681,69,43,65,49,44,35
"1152","5313","PORT LAVACA, TX",365014401,7003775,51570991,"2016-12","2016"," TX","Port Lavaca","48057","Calhoun",134015237,294919689,346490680,141019012,499029638,69,43,65,49,44,35
"1153","5313","PORT LAVACA, TX",659176696,16202088,42026470,"2017-12","2017"," TX","Port Lavaca","48057","Calhoun",124292111,271211602,313238072,140494199,783468807,69,43,65,49,44,35
"1154","5313","PORT LAVACA, TX",1129925944,0,0,"2018-12","2018"," TX","Port Lavaca","48057","Calhoun",244097272,344592676,344592676,244097272,1374023216,69,43,65,49,44,35
"1155","5313","PORT LAVACA, TX",786889861,26017938,23907220,"2019-12","2019"," TX","Port Lavaca","48057","Calhoun",106410617,245104257,269011477,132428555,893300478,69,43,65,49,44,35
"1156","5313","PORT LAVACA, TX",707517552,1745605,9853829,"2020-12","2020"," TX","Port Lavaca","48057","Calhoun",34210642,119789758,129643587,35956247,741728194,69,43,65,49,44,35
"1157","5313","PORT LAVACA, TX",1168650607,3089770,4518396,"2021-12","2021"," TX","Port Lavaca","48057","Calhoun",60925134,66246301,70764697,64014904,1229575741,69,43,65,49,44,35
"1158","1821","PORT MANATEE, FL",232719135,5251905,3478864,"2013-12","2013"," FL","Port Manatee","12081","Manatee",133905701,266441854,269920718,139157606,366624836,83,35,61,50,37,27
"1159","1821","PORT MANATEE, FL",102862576,6114352,3286029,"2014-12","2014"," FL","Port Manatee","12081","Manatee",162549833,311952196,315238225,168664185,265412409,83,35,61,50,37,27
"1160","1821","PORT MANATEE, FL",110262911,8652303,6283946,"2015-12","2015"," FL","Port Manatee","12081","Manatee",217921171,390913351,397197297,226573474,328184082,83,35,61,50,37,27
"1161","1821","PORT MANATEE, FL",107051313,19216523,35077481,"2016-12","2016"," FL","Port Manatee","12081","Manatee",312400203,363203637,398281118,331616726,419451516,83,35,61,50,37,27
"1162","1821","PORT MANATEE, FL",97808703,26554095,42406804,"2017-12","2017"," FL","Port Manatee","12081","Manatee",255105570,343015200,385422004,281659665,352914273,83,35,61,50,37,27
"1163","1821","PORT MANATEE, FL",105918007,37550618,49990311,"2018-12","2018"," FL","Port Manatee","12081","Manatee",249378306,381777483,431767794,286928924,355296313,83,35,61,50,37,27
"1164","1821","PORT MANATEE, FL",152415434,15410346,25043245,"2019-12","2019"," FL","Port Manatee","12081","Manatee",430065915,469280474,494323719,445476261,582481349,83,35,61,50,37,27
"1165","1821","PORT MANATEE, FL",72436921,16429181,48378374,"2020-12","2020"," FL","Port Manatee","12081","Manatee",511905833,525467871,573846245,528335014,584342754,83,35,61,50,37,27
"1166","1821","PORT MANATEE, FL",208179859,95945924,196356363,"2021-12","2021"," FL","Port Manatee","12081","Manatee",701473410,855946261,1052302624,797419334,909653269,83,35,61,50,37,27
"1167","3008","PORT TOWNSEND, WA",553762985,550206952,889915,"2013-12","2013"," WA","Port Townsend","53031","Jefferson",573352,6538,896453,550780304,554336337,94,113,39,96,108,126
"1168","3008","PORT TOWNSEND, WA",132220735,129698732,558056,"2014-12","2014"," WA","Port Townsend","53031","Jefferson",922440,67804,625860,130621172,133143175,94,113,39,96,108,126
"1169","3008","PORT TOWNSEND, WA",809657693,805904268,1920957,"2015-12","2015"," WA","Port Townsend","53031","Jefferson",456600,56882,1977839,806360868,810114293,94,113,39,96,108,126
"1170","3008","PORT TOWNSEND, WA",44172341,43211579,274511,"2016-12","2016"," WA","Port Townsend","53031","Jefferson",1764712,37181,311692,44976291,45937053,94,113,39,96,108,126
"1171","3008","PORT TOWNSEND, WA",1468040,0,0,"2017-12","2017"," WA","Port Townsend","53031","Jefferson",1369345,29396,29396,1369345,2837385,94,113,39,96,108,126
"1172","3008","PORT TOWNSEND, WA",2138168,317053,759,"2018-12","2018"," WA","Port Townsend","53031","Jefferson",24750,5522,6281,341803,2162918,94,113,39,96,108,126
"1173","3008","PORT TOWNSEND, WA",1582174,475123,8708,"2019-12","2019"," WA","Port Townsend","53031","Jefferson",0,0,8708,475123,1582174,94,113,39,96,108,126
"1174","3008","PORT TOWNSEND, WA",1170494,0,0,"2020-12","2020"," WA","Port Townsend","53031","Jefferson",56354,2178,2178,56354,1226848,94,113,39,96,108,126
"1175","3008","PORT TOWNSEND, WA",9125403,0,0,"2021-12","2021"," WA","Port Townsend","53031","Jefferson",229084,57302,57302,229084,9354487,94,113,39,96,108,126
"1176","0101","PORTLAND, ME",76473630,34657121,13572595,"2013-12","2013"," ME","Portland","23005","Cumberland",157248353,44880254,58452849,191905474,233721983,72,48,36,52,35,46
"1177","0101","PORTLAND, ME",227733907,57783959,20624038,"2014-12","2014"," ME","Portland","23005","Cumberland",242010224,75513911,96137949,299794183,469744131,72,48,36,52,35,46
"1178","0101","PORTLAND, ME",198546469,106656508,31999664,"2015-12","2015"," ME","Portland","23005","Cumberland",264963462,73561838,105561502,371619970,463509931,72,48,36,52,35,46
"1179","0101","PORTLAND, ME",185925288,118206699,31859804,"2016-12","2016"," ME","Portland","23005","Cumberland",283461733,98100707,129960511,401668432,469387021,72,48,36,52,35,46
"1180","0101","PORTLAND, ME",266295593,162465906,35129468,"2017-12","2017"," ME","Portland","23005","Cumberland",339681403,126237666,161367134,502147309,605976996,72,48,36,52,35,46
"1181","0101","PORTLAND, ME",351642662,223857150,42024600,"2018-12","2018"," ME","Portland","23005","Cumberland",492322222,132131488,174156088,716179372,843964884,72,48,36,52,35,46
"1182","0101","PORTLAND, ME",336472844,251839337,48035679,"2019-12","2019"," ME","Portland","23005","Cumberland",593155412,138335159,186370838,844994749,929628256,72,48,36,52,35,46
"1183","0101","PORTLAND, ME",475483997,269103844,38278426,"2020-12","2020"," ME","Portland","23005","Cumberland",612965491,155125900,193404326,882069335,1088449488,72,48,36,52,35,46
"1184","0101","PORTLAND, ME",823334850,694666073,71066961,"2021-12","2021"," ME","Portland","23005","Cumberland",898398631,192327368,263394329,1593064704,1721733481,72,48,36,52,35,46
"1185","2904","PORTLAND, OR",4423066195,782803698,716088928,"2013-12","2013"," OR","Portland","41067","Washington",2154389673,1131273923,1847362851,2937193371,6577455868,42,26,29,27,28,32
"1186","2904","PORTLAND, OR",5282872253,623106306,544691773,"2014-12","2014"," OR","Portland","41067","Washington",1958731429,1000182656,1544874429,2581837735,7241603682,42,26,29,27,28,32
"1187","2904","PORTLAND, OR",3766353230,155570070,181593679,"2015-12","2015"," OR","Portland","41067","Washington",307014277,133762403,315356082,462584347,4073367507,42,26,29,27,28,32
"1188","2904","PORTLAND, OR",3882117526,78513769,257908341,"2016-12","2016"," OR","Portland","41067","Washington",10844960,2294284,260202625,89358729,3892962486,42,26,29,27,28,32
"1189","2904","PORTLAND, OR",5033247805,36148439,115770561,"2017-12","2017"," OR","Portland","41067","Washington",8069283,27314431,143084992,44217722,5041317088,42,26,29,27,28,32
"1190","2904","PORTLAND, OR",5106404570,88213895,325747650,"2018-12","2018"," OR","Portland","41067","Washington",35552545,18164027,343911677,123766440,5141957115,42,26,29,27,28,32
"1191","2904","PORTLAND, OR",4458156373,78399198,294928204,"2019-12","2019"," OR","Portland","41067","Washington",71549476,6822307,301750511,149948674,4529705849,42,26,29,27,28,32
"1192","2904","PORTLAND, OR",4045126048,486761682,298047913,"2020-12","2020"," OR","Portland","41067","Washington",669890417,207934311,505982224,1156652099,4715016465,42,26,29,27,28,32
"1193","2904","PORTLAND, OR",4849094850,667946988,476059310,"2021-12","2021"," OR","Portland","41067","Washington",1484904488,375674982,851734292,2152851476,6333999338,42,26,29,27,28,32
"1194","0131","PORTSMOUTH, NH",584179813,64975518,45998849,"2013-12","2013"," NH","Portsmouth","33015","Rockingham",37753553,9526255,55525104,102729071,621933366,77,58,56,61,63,50
"1195","0131","PORTSMOUTH, NH",223237971,24786161,16829784,"2014-12","2014"," NH","Portsmouth","33015","Rockingham",43477834,7714141,24543925,68263995,266715805,77,58,56,61,63,50
"1196","0131","PORTSMOUTH, NH",367390424,95733126,9453967,"2015-12","2015"," NH","Portsmouth","33015","Rockingham",21287610,4504780,13958747,117020736,388678034,77,58,56,61,63,50
"1197","0131","PORTSMOUTH, NH",420815229,141849597,6681739,"2016-12","2016"," NH","Portsmouth","33015","Rockingham",28560443,2826412,9508151,170410040,449375672,77,58,56,61,63,50
"1198","0131","PORTSMOUTH, NH",995902450,114433457,9222448,"2017-12","2017"," NH","Portsmouth","33015","Rockingham",37684638,64984984,74207432,152118095,1033587088,77,58,56,61,63,50
"1199","0131","PORTSMOUTH, NH",782521358,52326998,11277007,"2018-12","2018"," NH","Portsmouth","33015","Rockingham",7494237,40748760,52025767,59821235,790015595,77,58,56,61,63,50
"1200","0131","PORTSMOUTH, NH",786467656,37797478,2753849,"2019-12","2019"," NH","Portsmouth","33015","Rockingham",4377716,90782404,93536253,42175194,790845372,77,58,56,61,63,50
"1201","0131","PORTSMOUTH, NH",179248217,1464610,818192,"2020-12","2020"," NH","Portsmouth","33015","Rockingham",2879876,151201051,152019243,4344486,182128093,77,58,56,61,63,50
"1202","0131","PORTSMOUTH, NH",278850747,23592060,158941,"2021-12","2021"," NH","Portsmouth","33015","Rockingham",3830895,170735899,170894840,27422955,282681642,77,58,56,61,63,50
"1203","0502","PROVIDENCE, RI",299175646,533584,50999,"2013-12","2013"," RI","Providence","44007","Providence",584237854,28171401,28222400,584771438,883413500,75,51,75,66,36,44
"1204","0502","PROVIDENCE, RI",455109126,632496,92704,"2014-12","2014"," RI","Providence","44007","Providence",2248474,75194,167898,2880970,457357600,75,51,75,66,36,44
"1205","0502","PROVIDENCE, RI",214567266,44700,13463,"2015-12","2015"," RI","Providence","44007","Providence",26417014,2295150,2308613,26461714,240984280,75,51,75,66,36,44
"1206","0502","PROVIDENCE, RI",172592435,8700,3979,"2016-12","2016"," RI","Providence","44007","Providence",77473345,324367700,324371679,77482045,250065780,75,51,75,66,36,44
"1207","0502","PROVIDENCE, RI",225637061,12465783,39088214,"2017-12","2017"," RI","Providence","44007","Providence",72560896,278112089,317200303,85026679,298197957,75,51,75,66,36,44
"1208","0502","PROVIDENCE, RI",342900714,11560286,33834065,"2018-12","2018"," RI","Providence","44007","Providence",58739614,44246365,78080430,70299900,401640328,75,51,75,66,36,44
"1209","0502","PROVIDENCE, RI",333325619,7240610,1024544,"2019-12","2019"," RI","Providence","44007","Providence",66990753,74047330,75071874,74231363,400316372,75,51,75,66,36,44
"1210","0502","PROVIDENCE, RI",212325558,3076580,564496,"2020-12","2020"," RI","Providence","44007","Providence",743672561,145543033,146107529,746749141,955998119,75,51,75,66,36,44
"1211","0502","PROVIDENCE, RI",324701273,2494111,483787,"2021-12","2021"," RI","Providence","44007","Providence",1358412605,213661388,214145175,1360906716,1683113878,75,51,75,66,36,44
"1212","3708","RACINE, WI",5686555,174821,9453,"2013-12","2013"," WI","Racine","55101","Racine",57127,20235,29688,231948,5743682,163,129,103,122,128,116
"1213","3708","RACINE, WI",232644,185102,4638,"2014-12","2014"," WI","Racine","55101","Racine",362925,63205,67843,548027,595569,163,129,103,122,128,116
"1214","3708","RACINE, WI",170395,22779,5162,"2015-12","2015"," WI","Racine","55101","Racine",379612,270800,275962,402391,550007,163,129,103,122,128,116
"1215","3708","RACINE, WI",497328,141820,14440,"2016-12","2016"," WI","Racine","55101","Racine",84786,58127,72567,226606,582114,163,129,103,122,128,116
"1216","3708","RACINE, WI",389708,0,0,"2017-12","2017"," WI","Racine","55101","Racine",0,0,0,0,389708,163,129,103,122,128,116
"1217","3708","RACINE, WI",261301,0,0,"2018-12","2018"," WI","Racine","55101","Racine",0,0,0,0,261301,163,129,103,122,128,116
"1218","3708","RACINE, WI",708716,463791,81012,"2019-12","2019"," WI","Racine","55101","Racine",25800,8413,89425,489591,734516,163,129,103,122,128,116
"1219","3708","RACINE, WI",699068,0,0,"2020-12","2020"," WI","Racine","55101","Racine",0,0,0,0,699068,163,129,103,122,128,116
"1220","3708","RACINE, WI",4977840,3939177,162931,"2021-12","2021"," WI","Racine","55101","Racine",324306,46064,208995,4263483,5302146,163,129,103,122,128,116
"1221","2821","REDWOOD CITY, CA",138625,0,0,"2013-12","2013"," CA","Redwood City","06081","San Mateo",0,0,0,0,138625,132,66,168,168,121,58
"1222","2821","REDWOOD CITY, CA",13583977,0,0,"2014-12","2014"," CA","Redwood City","06081","San Mateo",0,0,0,0,13583977,132,66,168,168,121,58
"1223","2821","REDWOOD CITY, CA",5499550,0,0,"2015-12","2015"," CA","Redwood City","06081","San Mateo",281872,32940651,32940651,281872,5781422,132,66,168,168,121,58
"1224","2821","REDWOOD CITY, CA",32766644,0,0,"2016-12","2016"," CA","Redwood City","06081","San Mateo",0,0,0,0,32766644,132,66,168,168,121,58
"1225","2821","REDWOOD CITY, CA",28475465,0,0,"2017-12","2017"," CA","Redwood City","06081","San Mateo",6808,26000,26000,6808,28482273,132,66,168,168,121,58
"1226","2821","REDWOOD CITY, CA",21808739,0,0,"2018-12","2018"," CA","Redwood City","06081","San Mateo",511423,69719411,69719411,511423,22320162,132,66,168,168,121,58
"1227","2821","REDWOOD CITY, CA",27551894,0,0,"2019-12","2019"," CA","Redwood City","06081","San Mateo",577218,100629551,100629551,577218,28129112,132,66,168,168,121,58
"1228","2821","REDWOOD CITY, CA",16890123,0,0,"2020-12","2020"," CA","Redwood City","06081","San Mateo",0,0,0,0,16890123,132,66,168,168,121,58
"1229","2821","REDWOOD CITY, CA",15771788,0,0,"2021-12","2021"," CA","Redwood City","06081","San Mateo",488486,83685129,83685129,488486,16260274,132,66,168,168,121,58
"1230","1404","RICHMOND-PETERSBURG, VA",8924552,3020221,612318,"2013-12","2013"," VA","Richmond-Petersburg","51812","Virginia Beach",30959605,31337135,31949453,33979826,39884157,108,68,78,70,70,62
"1231","1404","RICHMOND-PETERSBURG, VA",4241198,2040037,1011832,"2014-12","2014"," VA","Richmond-Petersburg","51812","Virginia Beach",26669103,61629206,62641038,28709140,30910301,108,68,78,70,70,62
"1232","1404","RICHMOND-PETERSBURG, VA",25627468,2592943,1118965,"2015-12","2015"," VA","Richmond-Petersburg","51812","Virginia Beach",7150340,52073002,53191967,9743283,32777808,108,68,78,70,70,62
"1233","1404","RICHMOND-PETERSBURG, VA",5773858,1668361,572529,"2016-12","2016"," VA","Richmond-Petersburg","51812","Virginia Beach",15444274,1461297,2033826,17112635,21218132,108,68,78,70,70,62
"1234","1404","RICHMOND-PETERSBURG, VA",63761034,5874660,2062721,"2017-12","2017"," VA","Richmond-Petersburg","51812","Virginia Beach",4452457,7239683,9302404,10327117,68213491,108,68,78,70,70,62
"1235","1404","RICHMOND-PETERSBURG, VA",76529415,3842768,14691018,"2018-12","2018"," VA","Richmond-Petersburg","51812","Virginia Beach",5666424,1551178,16242196,9509192,82195839,108,68,78,70,70,62
"1236","1404","RICHMOND-PETERSBURG, VA",101133224,2059206,973630,"2019-12","2019"," VA","Richmond-Petersburg","51812","Virginia Beach",11958700,1697026,2670656,14017906,113091924,108,68,78,70,70,62
"1237","1404","RICHMOND-PETERSBURG, VA",129709570,1594404,506014,"2020-12","2020"," VA","Richmond-Petersburg","51812","Virginia Beach",7770381,31213314,31719328,9364785,137479951,108,68,78,70,70,62
"1238","1404","RICHMOND-PETERSBURG, VA",98980311,9602494,30996194,"2021-12","2021"," VA","Richmond-Petersburg","51812","Virginia Beach",9834516,10030967,41027161,19437010,108814827,108,68,78,70,70,62
"1239","2812","RICHMOND, CA",1483320270,172754092,181580637,"2013-12","2013"," CA","Richmond","06001","Alameda",219749228,264697167,446277804,392503320,1703069498,57,32,35,29,41,34
"1240","2812","RICHMOND, CA",2387768890,303283304,299108463,"2014-12","2014"," CA","Richmond","06001","Alameda",297645162,269439720,568548183,600928466,2685414052,57,32,35,29,41,34
"1241","2812","RICHMOND, CA",1664655829,188984353,287013810,"2015-12","2015"," CA","Richmond","06001","Alameda",270005874,287338230,574352040,458990227,1934661703,57,32,35,29,41,34
"1242","2812","RICHMOND, CA",1109483660,75239691,155959596,"2016-12","2016"," CA","Richmond","06001","Alameda",224256379,246671999,402631595,299496070,1333740039,57,32,35,29,41,34
"1243","2812","RICHMOND, CA",1528257422,231167464,336854286,"2017-12","2017"," CA","Richmond","06001","Alameda",215945682,262719696,599573982,447113146,1744203104,57,32,35,29,41,34
"1244","2812","RICHMOND, CA",1648232803,262565893,342814431,"2018-12","2018"," CA","Richmond","06001","Alameda",192506797,353093591,695908022,455072690,1840739600,57,32,35,29,41,34
"1245","2812","RICHMOND, CA",1990979402,247693766,366809424,"2019-12","2019"," CA","Richmond","06001","Alameda",121570163,238044486,604853910,369263929,2112549565,57,32,35,29,41,34
"1246","2812","RICHMOND, CA",1292070285,241457785,406274889,"2020-12","2020"," CA","Richmond","06001","Alameda",122530657,195323628,601598517,363988442,1414600942,57,32,35,29,41,34
"1247","2812","RICHMOND, CA",1878864694,229742625,334472383,"2021-12","2021"," CA","Richmond","06001","Alameda",222185710,385056698,719529081,451928335,2101050404,57,32,35,29,41,34
"1248","0903","ROCHESTER, NY",5186589,138257,28427,"2013-12","2013"," NY","Rochester","36055","Monroe",777323,41623,70050,915580,5963912,142,122,112,109,104,109
"1249","0903","ROCHESTER, NY",16796756,383382,23141,"2014-12","2014"," NY","Rochester","36055","Monroe",454660,55459,78600,838042,17251416,142,122,112,109,104,109
"1250","0903","ROCHESTER, NY",6374094,291341,55271,"2015-12","2015"," NY","Rochester","36055","Monroe",1122550,50207,105478,1413891,7496644,142,122,112,109,104,109
"1251","0903","ROCHESTER, NY",13960422,365153,125789,"2016-12","2016"," NY","Rochester","36055","Monroe",3109052,216270,342059,3474205,17069474,142,122,112,109,104,109
"1252","0903","ROCHESTER, NY",13802086,434921,206256,"2017-12","2017"," NY","Rochester","36055","Monroe",67260,3089,209345,502181,13869346,142,122,112,109,104,109
"1253","0903","ROCHESTER, NY",14015993,404148,248836,"2018-12","2018"," NY","Rochester","36055","Monroe",224652,49752,298588,628800,14240645,142,122,112,109,104,109
"1254","0903","ROCHESTER, NY",9326861,941033,156797,"2019-12","2019"," NY","Rochester","36055","Monroe",1086364,41894,198691,2027397,10413225,142,122,112,109,104,109
"1255","0903","ROCHESTER, NY",961130,283441,35815,"2020-12","2020"," NY","Rochester","36055","Monroe",635250,130277,166092,918691,1596380,142,122,112,109,104,109
"1256","0903","ROCHESTER, NY",3288999,0,0,"2021-12","2021"," NY","Rochester","36055","Monroe",461347,155882,155882,461347,3750346,142,122,112,109,104,109
"1257","0121","ROCKLAND, ME",161761,0,0,"2015-12","2015"," ME","Rockland","23013","Knox",0,0,0,0,161761,178,158,168,168,151,145
"1258","0121","ROCKLAND, ME",562535,0,0,"2016-12","2016"," ME","Rockland","23013","Knox",9066,6596,6596,9066,571601,178,158,168,168,151,145
"1259","0121","ROCKLAND, ME",517735,0,0,"2019-12","2019"," ME","Rockland","23013","Knox",0,0,0,0,517735,178,158,168,168,151,145
"1260","3818","ROGERS CITY, MI",1929199,0,0,"2013-12","2013"," MI","Rogers City","26141","Presque Isle",0,0,0,0,1929199,169,155,147,144,170,170
"1261","3818","ROGERS CITY, MI",1612154,0,0,"2014-12","2014"," MI","Rogers City","26141","Presque Isle",0,0,0,0,1612154,169,155,147,144,170,170
"1262","3818","ROGERS CITY, MI",251031,13500,11442,"2015-12","2015"," MI","Rogers City","26141","Presque Isle",0,0,11442,13500,251031,169,155,147,144,170,170
"1263","3804","SAGINAW-BAY CITY, MI",18000,18000,20000,"2013-12","2013"," MI","Saginaw/Bay City","26145","Saginaw",447869,34491,54491,465869,465869,149,85,149,146,98,77
"1264","3804","SAGINAW-BAY CITY, MI",66644,0,0,"2014-12","2014"," MI","Saginaw/Bay City","26145","Saginaw",6955,396,396,6955,73599,149,85,149,146,98,77
"1265","3804","SAGINAW-BAY CITY, MI",13000,0,0,"2015-12","2015"," MI","Saginaw/Bay City","26145","Saginaw",252996,8130493,8130493,252996,265996,149,85,149,146,98,77
"1266","3804","SAGINAW-BAY CITY, MI",1137935,0,0,"2018-12","2018"," MI","Saginaw/Bay City","26145","Saginaw",402377,23320,23320,402377,1540312,149,85,149,146,98,77
"1267","3804","SAGINAW-BAY CITY, MI",6124681,0,0,"2019-12","2019"," MI","Saginaw/Bay City","26145","Saginaw",4317451,8703017,8703017,4317451,10442132,149,85,149,146,98,77
"1268","3804","SAGINAW-BAY CITY, MI",2946853,6859,1149,"2020-12","2020"," MI","Saginaw/Bay City","26145","Saginaw",2890683,25880623,25881772,2897542,5837536,149,85,149,146,98,77
"1269","3804","SAGINAW-BAY CITY, MI",31349309,0,0,"2021-12","2021"," MI","Saginaw/Bay City","26145","Saginaw",111561,14046000,14046000,111561,31460870,149,85,149,146,98,77
"1270","0408","SALEM, MA",654390,474136,242078,"2013-12","2013"," MA","Salem","25009","Essex",281038,12492,254570,755174,935428,146,102,101,95,78,87
"1271","0408","SALEM, MA",1139930,610473,402467,"2014-12","2014"," MA","Salem","25009","Essex",3566969,3550876,3953343,4177442,4706899,146,102,101,95,78,87
"1272","0408","SALEM, MA",1362828,627381,352285,"2015-12","2015"," MA","Salem","25009","Essex",37416207,6809805,7162090,38043588,38779035,146,102,101,95,78,87
"1273","0408","SALEM, MA",312531,300047,581650,"2016-12","2016"," MA","Salem","25009","Essex",20771849,3365492,3947142,21071896,21084380,146,102,101,95,78,87
"1274","0408","SALEM, MA",655692,655692,237401,"2017-12","2017"," MA","Salem","25009","Essex",1134775,20802,258203,1790467,1790467,146,102,101,95,78,87
"1275","0408","SALEM, MA",397463,391456,124718,"2018-12","2018"," MA","Salem","25009","Essex",2420852,66349,191067,2812308,2818315,146,102,101,95,78,87
"1276","0408","SALEM, MA",1069586,644846,840852,"2019-12","2019"," MA","Salem","25009","Essex",467744,38440,879292,1112590,1537330,146,102,101,95,78,87
"1277","0408","SALEM, MA",717511,717511,499350,"2020-12","2020"," MA","Salem","25009","Essex",29180,4678,504028,746691,746691,146,102,101,95,78,87
"1278","0408","SALEM, MA",1070531,1070531,404072,"2021-12","2021"," MA","Salem","25009","Essex",298975,62895,466967,1369506,1369506,146,102,101,95,78,87
"1279","2501","SAN DIEGO, CA",895713708,62538160,9391907,"2013-12","2013"," CA","San Diego","06073","San Diego",952897340,513014903,522406810,1015435500,1848611048,59,27,46,57,27,23
"1280","2501","SAN DIEGO, CA",922915695,59932938,10728028,"2014-12","2014"," CA","San Diego","06073","San Diego",310967237,495979204,506707232,370900175,1233882932,59,27,46,57,27,23
"1281","2501","SAN DIEGO, CA",958158964,110273486,16669857,"2015-12","2015"," CA","San Diego","06073","San Diego",372522945,532492258,549162115,482796431,1330681909,59,27,46,57,27,23
"1282","2501","SAN DIEGO, CA",1962260002,61928740,17191620,"2016-12","2016"," CA","San Diego","06073","San Diego",488349031,658982617,676174237,550277771,2450609033,59,27,46,57,27,23
"1283","2501","SAN DIEGO, CA",789898095,101825514,25770448,"2017-12","2017"," CA","San Diego","06073","San Diego",423382278,628482434,654252882,525207792,1213280373,59,27,46,57,27,23
"1284","2501","SAN DIEGO, CA",910201564,94609531,17845616,"2018-12","2018"," CA","San Diego","06073","San Diego",475753620,644925220,662770836,570363151,1385955184,59,27,46,57,27,23
"1285","2501","SAN DIEGO, CA",934081826,129600838,20452752,"2019-12","2019"," CA","San Diego","06073","San Diego",465693699,676360548,696813300,595294537,1399775525,59,27,46,57,27,23
"1286","2501","SAN DIEGO, CA",802400629,71806427,18649414,"2020-12","2020"," CA","San Diego","06073","San Diego",1139714180,727063297,745712711,1211520607,1942114809,59,27,46,57,27,23
"1287","2501","SAN DIEGO, CA",1205304897,133656458,37421054,"2021-12","2021"," CA","San Diego","06073","San Diego",2121472932,826446697,863867751,2255129390,3326777829,59,27,46,57,27,23
"1288","2809","SAN FRANCISCO, CA",1662066016,40901193,40036641,"2013-12","2013"," CA","San Francisco","06081","San Mateo",661339023,208492630,248529271,702240216,2323405039,45,41,47,58,21,29
"1289","2809","SAN FRANCISCO, CA",1202273029,77378341,8642725,"2014-12","2014"," CA","San Francisco","06081","San Mateo",781291957,132049731,140692456,858670298,1983564986,45,41,47,58,21,29
"1290","2809","SAN FRANCISCO, CA",688505528,51160319,7543659,"2015-12","2015"," CA","San Francisco","06081","San Mateo",523931273,162377491,169921150,575091592,1212436801,45,41,47,58,21,29
"1291","2809","SAN FRANCISCO, CA",690589506,49882839,7944748,"2016-12","2016"," CA","San Francisco","06081","San Mateo",617213191,161824928,169769676,667096030,1307802697,45,41,47,58,21,29
"1292","2809","SAN FRANCISCO, CA",2160815279,88753069,8354349,"2017-12","2017"," CA","San Francisco","06081","San Mateo",1064687231,266140534,274494883,1153440300,3225502510,45,41,47,58,21,29
"1293","2809","SAN FRANCISCO, CA",1837565156,46551946,6853829,"2018-12","2018"," CA","San Francisco","06081","San Mateo",2535523700,441404146,448257975,2582075646,4373088856,45,41,47,58,21,29
"1294","2809","SAN FRANCISCO, CA",6586156165,98877558,13788131,"2019-12","2019"," CA","San Francisco","06081","San Mateo",2226064708,840531215,854319346,2324942266,8812220873,45,41,47,58,21,29
"1295","2809","SAN FRANCISCO, CA",4907258515,90778741,12054465,"2020-12","2020"," CA","San Francisco","06081","San Mateo",1906600292,526425304,538479769,1997379033,6813858807,45,41,47,58,21,29
"1296","2809","SAN FRANCISCO, CA",3046170143,228665192,52473136,"2021-12","2021"," CA","San Francisco","06081","San Mateo",2542378853,563899398,616372534,2771044045,5588548996,45,41,47,58,21,29
"1297","2829","SAN PABLO BAY, CA",129323981,43309616,50191884,"2013-12","2013"," CA","San Pablo Bay","06013","Contra Costa",3576639,1162347,51354231,46886255,132900620,114,69,63,53,102,96
"1298","2829","SAN PABLO BAY, CA",155032055,70015827,116648819,"2014-12","2014"," CA","San Pablo Bay","06013","Contra Costa",790944,712604,117361423,70806771,155822999,114,69,63,53,102,96
"1299","2829","SAN PABLO BAY, CA",29390708,22267245,21989320,"2015-12","2015"," CA","San Pablo Bay","06013","Contra Costa",395312,91650,22080970,22662557,29786020,114,69,63,53,102,96
"1300","2829","SAN PABLO BAY, CA",16387633,16080552,18657228,"2016-12","2016"," CA","San Pablo Bay","06013","Contra Costa",2022073,118460,18775688,18102625,18409706,114,69,63,53,102,96
"1301","2829","SAN PABLO BAY, CA",21832879,21700128,24001979,"2017-12","2017"," CA","San Pablo Bay","06013","Contra Costa",1728878,336728,24338707,23429006,23561757,114,69,63,53,102,96
"1302","2829","SAN PABLO BAY, CA",9336658,9211925,5179554,"2018-12","2018"," CA","San Pablo Bay","06013","Contra Costa",376516,100883,5280437,9588441,9713174,114,69,63,53,102,96
"1303","2829","SAN PABLO BAY, CA",32129756,7802000,2038000,"2019-12","2019"," CA","San Pablo Bay","06013","Contra Costa",29446,26064,2064064,7831446,32159202,114,69,63,53,102,96
"1304","2829","SAN PABLO BAY, CA",2419000,2405000,630000,"2020-12","2020"," CA","San Pablo Bay","06013","Contra Costa",0,0,630000,2405000,2419000,114,69,63,53,102,96
"1305","2829","SAN PABLO BAY, CA",65000,65000,17000,"2021-12","2021"," CA","San Pablo Bay","06013","Contra Costa",4932,9540,26540,69932,69932,114,69,63,53,102,96
"1306","3803","SAULT STE MARIE, MI",1215669450,4135223,819583,"2013-12","2013"," MI","Sault Ste. Marie","26033","Chippewa",0,0,819583,4135223,1215669450,64,77,86,106,103,72
"1307","3803","SAULT STE MARIE, MI",1145423828,84960,19198,"2014-12","2014"," MI","Sault Ste. Marie","26033","Chippewa",7345274,7097000,7116198,7430234,1152769102,64,77,86,106,103,72
"1308","3803","SAULT STE MARIE, MI",1133521095,151713,36127,"2015-12","2015"," MI","Sault Ste. Marie","26033","Chippewa",349681,14765,50892,501394,1133870776,64,77,86,106,103,72
"1309","3803","SAULT STE MARIE, MI",1013869237,211205,23396,"2016-12","2016"," MI","Sault Ste. Marie","26033","Chippewa",0,0,23396,211205,1013869237,64,77,86,106,103,72
"1310","3803","SAULT STE MARIE, MI",1233589951,1108639,74994,"2017-12","2017"," MI","Sault Ste. Marie","26033","Chippewa",374252,24787215,24862209,1482891,1233964203,64,77,86,106,103,72
"1311","3803","SAULT STE MARIE, MI",1350809428,8757176,141213,"2018-12","2018"," MI","Sault Ste. Marie","26033","Chippewa",0,0,141213,8757176,1350809428,64,77,86,106,103,72
"1312","3803","SAULT STE MARIE, MI",1351482727,4503560,265337,"2019-12","2019"," MI","Sault Ste. Marie","26033","Chippewa",443632,54153000,54418337,4947192,1351926359,64,77,86,106,103,72
"1313","3803","SAULT STE MARIE, MI",1355371614,927284,22180,"2020-12","2020"," MI","Sault Ste. Marie","26033","Chippewa",180657,22132009,22154189,1107941,1355552271,64,77,86,106,103,72
"1314","3803","SAULT STE MARIE, MI",1439559500,0,0,"2021-12","2021"," MI","Sault Ste. Marie","26033","Chippewa",0,0,0,0,1439559500,64,77,86,106,103,72
"1315","1703","SAVANNAH, GA",29251054074,20020861819,10831697223,"2013-12","2013"," GA","Savannah","13103","Effingham",39454425512,8507965892,19339663115,59475287331,68705479586,4,2,6,3,2,2
"1316","1703","SAVANNAH, GA",29672905679,20447036501,11306354500,"2014-12","2014"," GA","Savannah","13103","Effingham",48344594669,9921873735,21228228235,68791631170,78017500348,4,2,6,3,2,2
"1317","1703","SAVANNAH, GA",27913456793,18347439859,10678588904,"2015-12","2015"," GA","Savannah","13103","Effingham",57852058061,11365955409,22044544313,76199497920,85765514854,4,2,6,3,2,2
"1318","1703","SAVANNAH, GA",24552014472,16709940829,10912699532,"2016-12","2016"," GA","Savannah","13103","Effingham",55302129175,11897383500,22810083032,72012070004,79854143647,4,2,6,3,2,2
"1319","1703","SAVANNAH, GA",26393953393,20141175281,1.2289e+10,"2017-12","2017"," GA","Savannah","13103","Effingham",59732626330,12796477055,25085477994,79873801611,86126579723,4,2,6,3,2,2
"1320","1703","SAVANNAH, GA",28250122504,22616376924,13928695368,"2018-12","2018"," GA","Savannah","13103","Effingham",69241674386,14123904661,28052600029,91858051310,97491796890,4,2,6,3,2,2
"1321","1703","SAVANNAH, GA",29893610529,23964823433,13569265684,"2019-12","2019"," GA","Savannah","13103","Effingham",73092436662,14796030075,28365295759,97057260095,1.02986e+11,4,2,6,3,2,2
"1322","1703","SAVANNAH, GA",27880752792,22748414337,13852046987,"2020-12","2020"," GA","Savannah","13103","Effingham",72811196718,14994657647,28846704634,95559611055,100691949510,4,2,6,3,2,2
"1323","1703","SAVANNAH, GA",30164909439,24188711333,14192600877,"2021-12","2021"," GA","Savannah","13103","Effingham",91395838781,18690231716,32882832593,115584550114,121560748220,4,2,6,3,2,2
"1324","0152","SEARSPORT, ME",188707,0,0,"2013-12","2013"," ME","Searsport","23027","Waldo",68364,19293,19293,68364,257071,117,76,117,111,65,71
"1325","0152","SEARSPORT, ME",138784,0,0,"2014-12","2014"," ME","Searsport","23027","Waldo",25104195,2037351,2037351,25104195,25242979,117,76,117,111,65,71
"1326","0152","SEARSPORT, ME",2076085,65550,51325,"2015-12","2015"," ME","Searsport","23027","Waldo",15296985,1139303,1190628,15362535,17373070,117,76,117,111,65,71
"1327","0152","SEARSPORT, ME",13641449,158919,157808,"2016-12","2016"," ME","Searsport","23027","Waldo",76145951,10393017,10550825,76304870,89787400,117,76,117,111,65,71
"1328","0152","SEARSPORT, ME",15414384,96401,83661,"2017-12","2017"," ME","Searsport","23027","Waldo",10026397,41332921,41416582,10122798,25440781,117,76,117,111,65,71
"1329","0152","SEARSPORT, ME",23923675,69271,32189,"2018-12","2018"," ME","Searsport","23027","Waldo",6318386,490340,522529,6387657,30242061,117,76,117,111,65,71
"1330","0152","SEARSPORT, ME",56172864,311985,80600,"2019-12","2019"," ME","Searsport","23027","Waldo",61094,66936,147536,373079,56233958,117,76,117,111,65,71
"1331","0152","SEARSPORT, ME",9715898,222600,222080,"2020-12","2020"," ME","Searsport","23027","Waldo",8740975,12541996,12764076,8963575,18456873,117,76,117,111,65,71
"1332","0152","SEARSPORT, ME",31774117,1046582,183213,"2021-12","2021"," ME","Searsport","23027","Waldo",31311144,41258309,41441522,32357726,63085261,117,76,117,111,65,71
"1333","3001","SEATTLE, WA",7695371982,4936843721,4457367473,"2013-12","2013"," WA","Seattle","53035","Kitsap",20242168387,4186254387,8643621860,25179012108,27937540369,17,10,14,10,10,10
"1334","3001","SEATTLE, WA",7947129473,4454329654,3968948670,"2014-12","2014"," WA","Seattle","53035","Kitsap",13496299233,3493072869,7462021539,17950628887,21443428706,17,10,14,10,10,10
"1335","3001","SEATTLE, WA",7150159055,3949287258,3644835514,"2015-12","2015"," WA","Seattle","53035","Kitsap",14575628801,3363593820,7008429334,18524916059,21725787856,17,10,14,10,10,10
"1336","3001","SEATTLE, WA",6519451095,3903548670,3919195958,"2016-12","2016"," WA","Seattle","53035","Kitsap",14318620893,3422337188,7341533146,18222169563,20838071988,17,10,14,10,10,10
"1337","3001","SEATTLE, WA",8263384633,5070936700,4593097592,"2017-12","2017"," WA","Seattle","53035","Kitsap",17232920388,4249441749,8842539341,22303857088,25496305021,17,10,14,10,10,10
"1338","3001","SEATTLE, WA",9099148250,5899944741,4767668067,"2018-12","2018"," WA","Seattle","53035","Kitsap",20299924452,4916049008,9683717075,26199869193,29399072702,17,10,14,10,10,10
"1339","3001","SEATTLE, WA",8486159806,5923483353,4482357864,"2019-12","2019"," WA","Seattle","53035","Kitsap",18151754488,4384932241,8867290105,24075237841,26637914294,17,10,14,10,10,10
"1340","3001","SEATTLE, WA",8266519276,5753841110,4382847450,"2020-12","2020"," WA","Seattle","53035","Kitsap",16864733352,4236248098,8619095548,22618574462,25131252628,17,10,14,10,10,10
"1341","3001","SEATTLE, WA",8931616095,5833096010,3923655846,"2021-12","2021"," WA","Seattle","53035","Kitsap",21997418560,4800192529,8723848375,27830514570,30929034655,17,10,14,10,10,10
"1342","2827","SELBY, CA",47709712,0,0,"2014-12","2014"," CA","Selby","06013","Contra Costa",0,0,0,0,47709712,122,92,148,150,83,79
"1343","2827","SELBY, CA",32207814,27394,1206,"2015-12","2015"," CA","Selby","06013","Contra Costa",0,0,1206,27394,32207814,122,92,148,150,83,79
"1344","2827","SELBY, CA",11180806,0,0,"2016-12","2016"," CA","Selby","06013","Contra Costa",0,0,0,0,11180806,122,92,148,150,83,79
"1345","2827","SELBY, CA",19097052,0,0,"2017-12","2017"," CA","Selby","06013","Contra Costa",17678,7275,7275,17678,19114730,122,92,148,150,83,79
"1346","2827","SELBY, CA",45478873,0,0,"2018-12","2018"," CA","Selby","06013","Contra Costa",0,0,0,0,45478873,122,92,148,150,83,79
"1347","2827","SELBY, CA",119685,0,0,"2019-12","2019"," CA","Selby","06013","Contra Costa",0,0,0,0,119685,122,92,148,150,83,79
"1348","2827","SELBY, CA",4124000,0,0,"2021-12","2021"," CA","Selby","06013","Contra Costa",35054310,35054310,35054310,35054310,39178310,122,92,148,150,83,79
"1349","3707","SHEBOYGAN, WI",97124,75924,16209,"2018-12","2018"," WI","Sheboygan","55117","Sheboygan",0,0,16209,75924,97124,184,147,130,127,146,146
"1350","3707","SHEBOYGAN, WI",17533,0,0,"2020-12","2020"," WI","Sheboygan","55117","Sheboygan",16952,2575,2575,16952,34485,184,147,130,127,146,146
"1351","3707","SHEBOYGAN, WI",56998,56998,36086,"2021-12","2021"," WI","Sheboygan","55117","Sheboygan",25813,3737,39823,82811,82811,184,147,130,127,146,146
"1352","2018","SHREVEPORT-BOSSIER CITY, LA",26159954,0,0,"2013-12","2013"," LA","Shreveport/Bossier City","22017","Caddo ",0,0,0,0,26159954,124,172.5,168,168,170,170
"1353","2018","SHREVEPORT-BOSSIER CITY, LA",13947210,0,0,"2014-12","2014"," LA","Shreveport/Bossier City","22017","Caddo ",0,0,0,0,13947210,124,172.5,168,168,170,170
"1354","2018","SHREVEPORT-BOSSIER CITY, LA",22471581,0,0,"2015-12","2015"," LA","Shreveport/Bossier City","22017","Caddo ",0,0,0,0,22471581,124,172.5,168,168,170,170
"1355","2018","SHREVEPORT-BOSSIER CITY, LA",26201494,0,0,"2016-12","2016"," LA","Shreveport/Bossier City","22017","Caddo ",0,0,0,0,26201494,124,172.5,168,168,170,170
"1356","2018","SHREVEPORT-BOSSIER CITY, LA",39063499,0,0,"2017-12","2017"," LA","Shreveport/Bossier City","22017","Caddo ",0,0,0,0,39063499,124,172.5,168,168,170,170
"1357","2018","SHREVEPORT-BOSSIER CITY, LA",29389323,0,0,"2018-12","2018"," LA","Shreveport/Bossier City","22017","Caddo ",0,0,0,0,29389323,124,172.5,168,168,170,170
"1358","2018","SHREVEPORT-BOSSIER CITY, LA",13859865,0,0,"2019-12","2019"," LA","Shreveport/Bossier City","22017","Caddo ",0,0,0,0,13859865,124,172.5,168,168,170,170
"1359","2018","SHREVEPORT-BOSSIER CITY, LA",18873558,0,0,"2020-12","2020"," LA","Shreveport/Bossier City","22017","Caddo ",0,0,0,0,18873558,124,172.5,168,168,170,170
"1360","2018","SHREVEPORT-BOSSIER CITY, LA",34709673,0,0,"2021-12","2021"," LA","Shreveport/Bossier City","22017","Caddo ",0,0,0,0,34709673,124,172.5,168,168,170,170
"1361","3115","SITKA, AK",5472892,71849,39517,"2013-12","2013"," AK","Sitka","02105","Hoonah-Angoon",0,0,39517,71849,5472892,170,148,140,130,129,141
"1362","3115","SITKA, AK",6036,0,0,"2014-12","2014"," AK","Sitka","02105","Hoonah-Angoon",102114,19376,19376,102114,108150,170,148,140,130,129,141
"1363","3115","SITKA, AK",111576,96000,70752,"2015-12","2015"," AK","Sitka","02105","Hoonah-Angoon",0,0,70752,96000,111576,170,148,140,130,129,141
"1364","3115","SITKA, AK",117011,0,0,"2016-12","2016"," AK","Sitka","02105","Hoonah-Angoon",0,0,0,0,117011,170,148,140,130,129,141
"1365","3115","SITKA, AK",43957,0,0,"2017-12","2017"," AK","Sitka","02105","Hoonah-Angoon",0,0,0,0,43957,170,148,140,130,129,141
"1366","3115","SITKA, AK",3929792,0,0,"2018-12","2018"," AK","Sitka","02105","Hoonah-Angoon",0,0,0,0,3929792,170,148,140,130,129,141
"1367","3115","SITKA, AK",3206,0,0,"2019-12","2019"," AK","Sitka","02105","Hoonah-Angoon",0,0,0,0,3206,170,148,140,130,129,141
"1368","3115","SITKA, AK",167641,0,0,"2020-12","2020"," AK","Sitka","02105","Hoonah-Angoon",1083925,25534,25534,1083925,1251566,170,148,140,130,129,141
"1369","3115","SITKA, AK",39773,0,0,"2021-12","2021"," AK","Sitka","02105","Hoonah-Angoon",0,0,0,0,39773,170,148,140,130,129,141
"1370","3103","SKAGWAY, AK",138899451,0,0,"2013-12","2013"," AK","Skagway","02230","Skagway",0,0,0,0,138899451,92,149,139,134,142,142
"1371","3103","SKAGWAY, AK",211107223,0,0,"2014-12","2014"," AK","Skagway","02230","Skagway",0,0,0,0,211107223,92,149,139,134,142,142
"1372","3103","SKAGWAY, AK",127976097,0,0,"2015-12","2015"," AK","Skagway","02230","Skagway",0,0,0,0,127976097,92,149,139,134,142,142
"1373","3103","SKAGWAY, AK",150441994,0,0,"2016-12","2016"," AK","Skagway","02230","Skagway",0,0,0,0,150441994,92,149,139,134,142,142
"1374","3103","SKAGWAY, AK",153526965,0,0,"2017-12","2017"," AK","Skagway","02230","Skagway",150852,7104,7104,150852,153677817,92,149,139,134,142,142
"1375","3103","SKAGWAY, AK",225223134,170848,76228,"2018-12","2018"," AK","Skagway","02230","Skagway",0,0,76228,170848,225223134,92,149,139,134,142,142
"1376","3103","SKAGWAY, AK",180065625,0,0,"2019-12","2019"," AK","Skagway","02230","Skagway",0,0,0,0,180065625,92,149,139,134,142,142
"1377","3103","SKAGWAY, AK",342233785,0,0,"2020-12","2020"," AK","Skagway","02230","Skagway",0,0,0,0,342233785,92,149,139,134,142,142
"1378","3103","SKAGWAY, AK",272573512,0,0,"2021-12","2021"," AK","Skagway","02230","Skagway",281893,24318,24318,281893,272855405,92,149,139,134,142,142
"1379","0905","SODUS POINT, NY",7925031,0,0,"2013-12","2013"," NY","Sodus Point","36117","Wayne",0,0,0,0,7925031,158,152,168,168,139,139
"1380","0905","SODUS POINT, NY",1048200,0,0,"2014-12","2014"," NY","Sodus Point","36117","Wayne",51101,8084,8084,51101,1099301,158,152,168,168,139,139
"1381","0905","SODUS POINT, NY",580159,0,0,"2016-12","2016"," NY","Sodus Point","36117","Wayne",10014,1067,1067,10014,590173,158,152,168,168,139,139
"1382","0905","SODUS POINT, NY",315560,0,0,"2017-12","2017"," NY","Sodus Point","36117","Wayne",31240,3850,3850,31240,346800,158,152,168,168,139,139
"1383","0905","SODUS POINT, NY",223449,0,0,"2018-12","2018"," NY","Sodus Point","36117","Wayne",259984,20971,20971,259984,483433,158,152,168,168,139,139
"1384","0905","SODUS POINT, NY",13609654,0,0,"2019-12","2019"," NY","Sodus Point","36117","Wayne",27991,4262,4262,27991,13637645,158,152,168,168,139,139
"1385","0905","SODUS POINT, NY",293433,0,0,"2021-12","2021"," NY","Sodus Point","36117","Wayne",24275,633,633,24275,317708,158,152,168,168,139,139
"1386","1814","ST. PETERSBURG, FL",37142,0,0,"2013-12","2013"," FL","St. Petersburg","12057","Hillsborough",128901,10192,10192,128901,166043,164,131,107,123,120,119
"1387","1814","ST. PETERSBURG, FL",134995,122099,11350,"2014-12","2014"," FL","St. Petersburg","12057","Hillsborough",300643,119568,130918,422742,435638,164,131,107,123,120,119
"1388","1814","ST. PETERSBURG, FL",2221784,2161309,37816,"2015-12","2015"," FL","St. Petersburg","12057","Hillsborough",214976,77413,115229,2376285,2436760,164,131,107,123,120,119
"1389","1814","ST. PETERSBURG, FL",773539,749172,51625,"2016-12","2016"," FL","St. Petersburg","12057","Hillsborough",792867,56840,108465,1542039,1566406,164,131,107,123,120,119
"1390","1814","ST. PETERSBURG, FL",1009674,187855,55065,"2017-12","2017"," FL","St. Petersburg","12057","Hillsborough",113105,25392,80457,300960,1122779,164,131,107,123,120,119
"1391","1814","ST. PETERSBURG, FL",340969,303494,26281,"2018-12","2018"," FL","St. Petersburg","12057","Hillsborough",0,0,26281,303494,340969,164,131,107,123,120,119
"1392","1814","ST. PETERSBURG, FL",7403950,0,0,"2019-12","2019"," FL","St. Petersburg","12057","Hillsborough",35259,3181,3181,35259,7439209,164,131,107,123,120,119
"1393","1814","ST. PETERSBURG, FL",144192,69558,38100,"2020-12","2020"," FL","St. Petersburg","12057","Hillsborough",254849,101415,139515,324407,399041,164,131,107,123,120,119
"1394","1814","ST. PETERSBURG, FL",507030,138925,1321,"2021-12","2021"," FL","St. Petersburg","12057","Hillsborough",54386,31371,32692,193311,561416,164,131,107,123,120,119
"1395","2810","STOCKTON, CA",354862184,26100,120757,"2013-12","2013"," CA","Stockton","06077","San Joaquin",131243577,291646303,291767060,131269677,486105761,81,50,76,72,54,40
"1396","2810","STOCKTON, CA",446259402,3726420,8090681,"2014-12","2014"," CA","Stockton","06077","San Joaquin",81387524,97142923,105233604,85113944,527646926,81,50,76,72,54,40
"1397","2810","STOCKTON, CA",372647932,535223,89253,"2015-12","2015"," CA","Stockton","06077","San Joaquin",102570415,189403744,189492997,103105638,475218347,81,50,76,72,54,40
"1398","2810","STOCKTON, CA",318289085,75130,13717,"2016-12","2016"," CA","Stockton","06077","San Joaquin",127338856,187228108,187241825,127413986,445627941,81,50,76,72,54,40
"1399","2810","STOCKTON, CA",339555009,11234132,30569919,"2017-12","2017"," CA","Stockton","06077","San Joaquin",58043512,87521962,118091881,69277644,397598521,81,50,76,72,54,40
"1400","2810","STOCKTON, CA",434031841,379649,117126,"2018-12","2018"," CA","Stockton","06077","San Joaquin",57274338,123360336,123477462,57653987,491306179,81,50,76,72,54,40
"1401","2810","STOCKTON, CA",493025430,1002604,1662500,"2019-12","2019"," CA","Stockton","06077","San Joaquin",27760535,52906020,54568520,28763139,520785965,81,50,76,72,54,40
"1402","2810","STOCKTON, CA",370587667,18177745,2048638,"2020-12","2020"," CA","Stockton","06077","San Joaquin",29149287,46847613,48896251,47327032,399736954,81,50,76,72,54,40
"1403","2810","STOCKTON, CA",567386796,876716,1354272,"2021-12","2021"," CA","Stockton","06077","San Joaquin",109438825,142228291,143582563,110315541,676825621,81,50,76,72,54,40
"1404","3009","SUMAS, WA",1751010783,0,0,"2013-12","2013"," WA","Sumas","53073","Whatcom",0,0,0,0,1751010783,60,172.5,168,168,170,170
"1405","3009","SUMAS, WA",2192597651,0,0,"2014-12","2014"," WA","Sumas","53073","Whatcom",0,0,0,0,2192597651,60,172.5,168,168,170,170
"1406","3009","SUMAS, WA",2383084734,0,0,"2015-12","2015"," WA","Sumas","53073","Whatcom",0,0,0,0,2383084734,60,172.5,168,168,170,170
"1407","3009","SUMAS, WA",1358356573,0,0,"2016-12","2016"," WA","Sumas","53073","Whatcom",0,0,0,0,1358356573,60,172.5,168,168,170,170
"1408","3009","SUMAS, WA",1484001997,0,0,"2017-12","2017"," WA","Sumas","53073","Whatcom",0,0,0,0,1484001997,60,172.5,168,168,170,170
"1409","3009","SUMAS, WA",1690366173,0,0,"2018-12","2018"," WA","Sumas","53073","Whatcom",0,0,0,0,1690366173,60,172.5,168,168,170,170
"1410","3009","SUMAS, WA",1643085484,0,0,"2019-12","2019"," WA","Sumas","53073","Whatcom",0,0,0,0,1643085484,60,172.5,168,168,170,170
"1411","3009","SUMAS, WA",1295707992,0,0,"2020-12","2020"," WA","Sumas","53073","Whatcom",0,0,0,0,1295707992,60,172.5,168,168,170,170
"1412","3009","SUMAS, WA",1434725857,0,0,"2021-12","2021"," WA","Sumas","53073","Whatcom",0,0,0,0,1434725857,60,172.5,168,168,170,170
"1413","0906","SYRACUSE, NY",149907372,0,0,"2013-12","2013"," NY","Syracuse","36067","Onondaga",0,0,0,0,149907372,112,172.5,168,168,170,170
"1414","0906","SYRACUSE, NY",68514493,0,0,"2014-12","2014"," NY","Syracuse","36067","Onondaga",0,0,0,0,68514493,112,172.5,168,168,170,170
"1415","0906","SYRACUSE, NY",46405000,0,0,"2015-12","2015"," NY","Syracuse","36067","Onondaga",0,0,0,0,46405000,112,172.5,168,168,170,170
"1416","0906","SYRACUSE, NY",55225768,0,0,"2016-12","2016"," NY","Syracuse","36067","Onondaga",0,0,0,0,55225768,112,172.5,168,168,170,170
"1417","0906","SYRACUSE, NY",113072899,0,0,"2017-12","2017"," NY","Syracuse","36067","Onondaga",0,0,0,0,113072899,112,172.5,168,168,170,170
"1418","0906","SYRACUSE, NY",1677061,0,0,"2018-12","2018"," NY","Syracuse","36067","Onondaga",0,0,0,0,1677061,112,172.5,168,168,170,170
"1419","0906","SYRACUSE, NY",2851724,0,0,"2019-12","2019"," NY","Syracuse","36067","Onondaga",0,0,0,0,2851724,112,172.5,168,168,170,170
"1420","0906","SYRACUSE, NY",711426,0,0,"2020-12","2020"," NY","Syracuse","36067","Onondaga",0,0,0,0,711426,112,172.5,168,168,170,170
"1421","0906","SYRACUSE, NY",2911784,0,0,"2021-12","2021"," NY","Syracuse","36067","Onondaga",0,0,0,0,2911784,112,172.5,168,168,170,170
"1422","3002","TACOMA, WA",11151597279,7551097971,4926214468,"2013-12","2013"," WA","Tacoma","53053","Pierce",32791625070,4444336557,9370551025,40342723041,43943222349,12,9,11,9,6,9
"1423","3002","TACOMA, WA",11457106276,7993457586,5164573979,"2014-12","2014"," WA","Tacoma","53053","Pierce",35973974672,5142596200,10307170179,43967432258,47431080948,12,9,11,9,6,9
"1424","3002","TACOMA, WA",10074277247,7211778076,4957674264,"2015-12","2015"," WA","Tacoma","53053","Pierce",36856691646,5347340690,10305014954,44068469722,46930968893,12,9,11,9,6,9
"1425","3002","TACOMA, WA",10773146842,7852286878,6423495695,"2016-12","2016"," WA","Tacoma","53053","Pierce",38636193046,5622023655,12045519350,46488479924,49409339888,12,9,11,9,6,9
"1426","3002","TACOMA, WA",9717812522,7331750803,5989285255,"2017-12","2017"," WA","Tacoma","53053","Pierce",35507243215,4651227973,10640513228,42838994018,45225055737,12,9,11,9,6,9
"1427","3002","TACOMA, WA",8881815301,6813889319,6475314391,"2018-12","2018"," WA","Tacoma","53053","Pierce",35661860146,4604610370,11079924761,42475749465,44543675447,12,9,11,9,6,9
"1428","3002","TACOMA, WA",7950969711,6326556936,5983484417,"2019-12","2019"," WA","Tacoma","53053","Pierce",35656147392,4511024546,10494508963,41982704328,43607117103,12,9,11,9,6,9
"1429","3002","TACOMA, WA",7132674409,5045383937,4926339261,"2020-12","2020"," WA","Tacoma","53053","Pierce",29826590170,3950713338,8877052599,34871974107,36959264579,12,9,11,9,6,9
"1430","3002","TACOMA, WA",7871270098,5087249405,4140881017,"2021-12","2021"," WA","Tacoma","53053","Pierce",31593897753,4408544378,8549425395,36681147158,39465167851,12,9,11,9,6,9
"1431","1801","TAMPA, FL",2554443384,88347304,67048963,"2013-12","2013"," FL","Tampa","12057","Hillsborough",492284429,280201388,347250351,580631733,3046727813,49,31,45,39,24,26
"1432","1801","TAMPA, FL",2570474362,76920207,86429771,"2014-12","2014"," FL","Tampa","12057","Hillsborough",537014463,321673499,408103270,613934670,3107488825,49,31,45,39,24,26
"1433","1801","TAMPA, FL",2362018404,59952842,84195907,"2015-12","2015"," FL","Tampa","12057","Hillsborough",605829804,383868473,468064380,665782646,2967848208,49,31,45,39,24,26
"1434","1801","TAMPA, FL",2005976985,70521501,120625048,"2016-12","2016"," FL","Tampa","12057","Hillsborough",686685142,486525451,607150499,757206643,2692662127,49,31,45,39,24,26
"1435","1801","TAMPA, FL",2006521734,84237154,132322306,"2017-12","2017"," FL","Tampa","12057","Hillsborough",803723209,410779242,543101548,887960363,2810244943,49,31,45,39,24,26
"1436","1801","TAMPA, FL",1965865358,72297461,96288267,"2018-12","2018"," FL","Tampa","12057","Hillsborough",1038477516,561138873,657427140,1110774977,3004342874,49,31,45,39,24,26
"1437","1801","TAMPA, FL",1792053387,94258147,109560561,"2019-12","2019"," FL","Tampa","12057","Hillsborough",1131941474,495273081,604833642,1226199621,2923994861,49,31,45,39,24,26
"1438","1801","TAMPA, FL",1490080539,135994873,152487512,"2020-12","2020"," FL","Tampa","12057","Hillsborough",1246606868,515748568,668236080,1382601741,2736687407,49,31,45,39,24,26
"1439","1801","TAMPA, FL",1941713916,210803008,289383676,"2021-12","2021"," FL","Tampa","12057","Hillsborough",1596366179,971940336,1261324012,1807169187,3538080095,49,31,45,39,24,26
"1440","5306","TEXAS CITY, TX",9548112971,28208633,15335065,"2013-12","2013"," TX","Texas City","48071","Chambers",3964751,1615936,16951001,32173384,9552077722,37,39,28,25,88,81
"1441","5306","TEXAS CITY, TX",8803583430,426420728,301050546,"2014-12","2014"," TX","Texas City","48071","Chambers",7550957,15642368,316692914,433971685,8811134387,37,39,28,25,88,81
"1442","5306","TEXAS CITY, TX",6740913903,593114136,525055039,"2015-12","2015"," TX","Texas City","48071","Chambers",4727142,2022959,527077998,597841278,6745641045,37,39,28,25,88,81
"1443","5306","TEXAS CITY, TX",4854161202,490034127,536353381,"2016-12","2016"," TX","Texas City","48071","Chambers",97694,73854,536427235,490131821,4854258896,37,39,28,25,88,81
"1444","5306","TEXAS CITY, TX",5174100616,490011702,487686022,"2017-12","2017"," TX","Texas City","48071","Chambers",137150,23424,487709446,490148852,5174237766,37,39,28,25,88,81
"1445","5306","TEXAS CITY, TX",8065983218,499966133,450436068,"2018-12","2018"," TX","Texas City","48071","Chambers",395551,201409,450637477,500361684,8066378769,37,39,28,25,88,81
"1446","5306","TEXAS CITY, TX",8346744080,368547849,378465789,"2019-12","2019"," TX","Texas City","48071","Chambers",614647,136146,378601935,369162496,8347358727,37,39,28,25,88,81
"1447","5306","TEXAS CITY, TX",4434450459,248360184,724112278,"2020-12","2020"," TX","Texas City","48071","Chambers",428742,97134,724209412,248788926,4434879201,37,39,28,25,88,81
"1448","5306","TEXAS CITY, TX",4382698375,193950526,278851170,"2021-12","2021"," TX","Texas City","48071","Chambers",10654961,15897053,294748223,204605487,4393353336,37,39,28,25,88,81
"1449","4105","TOLEDO-SANDUSKY, OH",718546860,345030,185188,"2013-12","2013"," OH","Toledo","39173","Wood",23967898,46755608,46940796,24312928,742514758,76,65,88,73,64,59
"1450","4105","TOLEDO-SANDUSKY, OH",774067907,17409282,42057004,"2014-12","2014"," OH","Toledo","39173","Wood",4382935,6419675,48476679,21792217,778450842,76,65,88,73,64,59
"1451","4105","TOLEDO-SANDUSKY, OH",521047467,0,0,"2015-12","2015"," OH","Toledo","39173","Wood",5049315,2255806,2255806,5049315,526096782,76,65,88,73,64,59
"1452","4105","TOLEDO-SANDUSKY, OH",492181727,996164,440842,"2016-12","2016"," OH","Toledo","39173","Wood",32629585,17788105,18228947,33625749,524811312,76,65,88,73,64,59
"1453","4105","TOLEDO-SANDUSKY, OH",625753968,0,0,"2017-12","2017"," OH","Toledo","39173","Wood",10725758,4424320,4424320,10725758,636479726,76,65,88,73,64,59
"1454","4105","TOLEDO-SANDUSKY, OH",466574729,69395,43731,"2018-12","2018"," OH","Toledo","39173","Wood",4662170,99750478,99794209,4731565,471236899,76,65,88,73,64,59
"1455","4105","TOLEDO-SANDUSKY, OH",361086035,17920,8084,"2019-12","2019"," OH","Toledo","39173","Wood",11396869,50723165,50731249,11414789,372482904,76,65,88,73,64,59
"1456","4105","TOLEDO-SANDUSKY, OH",498194199,0,0,"2020-12","2020"," OH","Toledo","39173","Wood",24370276,11595509,11595509,24370276,522564475,76,65,88,73,64,59
"1457","4105","TOLEDO-SANDUSKY, OH",627635140,0,0,"2021-12","2021"," OH","Toledo","39173","Wood",63937860,35484854,35484854,63937860,691573000,76,65,88,73,64,59
"1458","0000","TOTAL FOR ALL US COASTAL PORTS",938711755531,2.44361e+11,101400796596,NA,"2013","United States","Total for all US Coastal Ports","00000","National",583962743122,117825466201,219226262797,828323786419,1.522674e+12,NA,NA,NA,NA,NA,NA
"1459","0000","TOTAL FOR ALL US COASTAL PORTS",966779486253,251995383327,101604229219,NA,"2014","United States","Total for all US Coastal Ports","00000","National",609553703106,126740664069,228344893288,861549086433,1.576333e+12,NA,NA,NA,NA,NA,NA
"1460","0000","TOTAL FOR ALL US COASTAL PORTS",874970159101,232018112387,98318543600,NA,"2015","United States","Total for all US Coastal Ports","00000","National",611157911968,134733183239,233051726839,8.43176e+11,1.486128e+12,NA,NA,NA,NA,NA,NA
"1461","0000","TOTAL FOR ALL US COASTAL PORTS",839064941952,230293806878,109348657117,NA,"2016","United States","Total for all US Coastal Ports","00000","National",604171753921,1.34926e+11,244274696753,834465560799,1.443237e+12,NA,NA,NA,NA,NA,NA
"1462","0000","TOTAL FOR ALL US COASTAL PORTS",8.98706e+11,254103593434,119665663740,NA,"2017","United States","Total for all US Coastal Ports","00000","National",636923343314,141675082952,261340746692,891026936748,1.535629e+12,NA,NA,NA,NA,NA,NA
"1463","0000","TOTAL FOR ALL US COASTAL PORTS",980993347422,275479446363,129826255614,NA,"2018","United States","Total for all US Coastal Ports","00000","National",690034092285,147681909977,277508165591,965513538648,1.671027e+12,NA,NA,NA,NA,NA,NA
"1464","0000","TOTAL FOR ALL US COASTAL PORTS",985545115037,271710544199,129108209118,NA,"2019","United States","Total for all US Coastal Ports","00000","National",672455499528,145136138071,274244347189,9.44166e+11,1.658001e+12,NA,NA,NA,NA,NA,NA
"1465","0000","TOTAL FOR ALL US COASTAL PORTS",850886368443,246743493281,125394923867,NA,"2020","United States","Total for all US Coastal Ports","00000","National",646254083285,145580192833,270975116700,892997576566,1.49714e+12,NA,NA,NA,NA,NA,NA
"1466","0000","TOTAL FOR ALL US COASTAL PORTS",1.025732e+12,273222270128,119207445073,NA,"2021","United States","Total for all US Coastal Ports","00000","National",781043314746,172481426342,291688871415,1.054266e+12,1.806776e+12,NA,NA,NA,NA,NA,NA
"1467","0108","VAN BUREN, ME",29663652,0,0,"2013-12","2013"," ME","Van Buren","23003","Aroostook",0,0,0,0,29663652,119,172.5,168,168,170,170
"1468","0108","VAN BUREN, ME",24459755,0,0,"2014-12","2014"," ME","Van Buren","23003","Aroostook",0,0,0,0,24459755,119,172.5,168,168,170,170
"1469","0108","VAN BUREN, ME",16173865,0,0,"2015-12","2015"," ME","Van Buren","23003","Aroostook",0,0,0,0,16173865,119,172.5,168,168,170,170
"1470","0108","VAN BUREN, ME",23123954,0,0,"2016-12","2016"," ME","Van Buren","23003","Aroostook",0,0,0,0,23123954,119,172.5,168,168,170,170
"1471","0108","VAN BUREN, ME",30674509,0,0,"2017-12","2017"," ME","Van Buren","23003","Aroostook",0,0,0,0,30674509,119,172.5,168,168,170,170
"1472","0108","VAN BUREN, ME",43543079,0,0,"2018-12","2018"," ME","Van Buren","23003","Aroostook",0,0,0,0,43543079,119,172.5,168,168,170,170
"1473","0108","VAN BUREN, ME",41736852,0,0,"2019-12","2019"," ME","Van Buren","23003","Aroostook",0,0,0,0,41736852,119,172.5,168,168,170,170
"1474","0108","VAN BUREN, ME",35593973,0,0,"2020-12","2020"," ME","Van Buren","23003","Aroostook",0,0,0,0,35593973,119,172.5,168,168,170,170
"1475","0108","VAN BUREN, ME",47243990,0,0,"2021-12","2021"," ME","Van Buren","23003","Aroostook",0,0,0,0,47243990,119,172.5,168,168,170,170
"1476","0105","VANCEBORO, ME",196011838,0,0,"2013-12","2013"," ME","Vanceboro","23029","Washington",0,0,0,0,196011838,110,172.5,168,168,170,170
"1477","0105","VANCEBORO, ME",50518200,0,0,"2014-12","2014"," ME","Vanceboro","23029","Washington",0,0,0,0,50518200,110,172.5,168,168,170,170
"1478","0105","VANCEBORO, ME",48707836,0,0,"2015-12","2015"," ME","Vanceboro","23029","Washington",0,0,0,0,48707836,110,172.5,168,168,170,170
"1479","0105","VANCEBORO, ME",30113997,0,0,"2016-12","2016"," ME","Vanceboro","23029","Washington",0,0,0,0,30113997,110,172.5,168,168,170,170
"1480","0105","VANCEBORO, ME",30764672,0,0,"2017-12","2017"," ME","Vanceboro","23029","Washington",0,0,0,0,30764672,110,172.5,168,168,170,170
"1481","0105","VANCEBORO, ME",27259533,0,0,"2018-12","2018"," ME","Vanceboro","23029","Washington",0,0,0,0,27259533,110,172.5,168,168,170,170
"1482","0105","VANCEBORO, ME",24204890,0,0,"2019-12","2019"," ME","Vanceboro","23029","Washington",0,0,0,0,24204890,110,172.5,168,168,170,170
"1483","0105","VANCEBORO, ME",29550788,0,0,"2020-12","2020"," ME","Vanceboro","23029","Washington",0,0,0,0,29550788,110,172.5,168,168,170,170
"1484","0105","VANCEBORO, ME",29046577,0,0,"2021-12","2021"," ME","Vanceboro","23029","Washington",0,0,0,0,29046577,110,172.5,168,168,170,170
"1485","2908","VANCOUVER, WA",2086606009,89118016,155597955,"2013-12","2013"," WA","Vancouver","53011","Clark",37847006,27452891,183050846,126965022,2124453015,53,47,53,38,58,55
"1486","2908","VANCOUVER, WA",2242657933,49969168,72993573,"2014-12","2014"," WA","Vancouver","53011","Clark",97834628,35462661,108456234,147803796,2340492561,53,47,53,38,58,55
"1487","2908","VANCOUVER, WA",1763056597,38677426,69204582,"2015-12","2015"," WA","Vancouver","53011","Clark",43261818,53747815,122952397,81939244,1806318415,53,47,53,38,58,55
"1488","2908","VANCOUVER, WA",1861627894,41776610,33227036,"2016-12","2016"," WA","Vancouver","53011","Clark",78607138,146462860,179689896,120383748,1940235032,53,47,53,38,58,55
"1489","2908","VANCOUVER, WA",1984173798,14992258,6578193,"2017-12","2017"," WA","Vancouver","53011","Clark",28139322,55224746,61802939,43131580,2012313120,53,47,53,38,58,55
"1490","2908","VANCOUVER, WA",2252403938,39187922,57796187,"2018-12","2018"," WA","Vancouver","53011","Clark",9288894,4637078,62433265,48476816,2261692832,53,47,53,38,58,55
"1491","2908","VANCOUVER, WA",2232452362,87248016,232992439,"2019-12","2019"," WA","Vancouver","53011","Clark",13032673,3764534,236756973,100280689,2245485035,53,47,53,38,58,55
"1492","2908","VANCOUVER, WA",2110024200,141857162,352455036,"2020-12","2020"," WA","Vancouver","53011","Clark",33144336,5641462,358096498,175001498,2143168536,53,47,53,38,58,55
"1493","2908","VANCOUVER, WA",2822323115,131575700,234618615,"2021-12","2021"," WA","Vancouver","53011","Clark",42724200,20254646,254873261,174299900,2865047315,53,47,53,38,58,55
"1494","2712","VENTURA, CA",1490637,0,0,"2013-12","2013"," CA","Ventura","06111","Ventura",50691,8864,8864,50691,1541328,177,141,128,128,137,130
"1495","2712","VENTURA, CA",1076042,8134,7765,"2014-12","2014"," CA","Ventura","06111","Ventura",7920,3664,11429,16054,1083962,177,141,128,128,137,130
"1496","2712","VENTURA, CA",44239,44239,2495,"2015-12","2015"," CA","Ventura","06111","Ventura",0,0,2495,44239,44239,177,141,128,128,137,130
"1497","2712","VENTURA, CA",224741,60471,4779,"2016-12","2016"," CA","Ventura","06111","Ventura",39024,5140,9919,99495,263765,177,141,128,128,137,130
"1498","2712","VENTURA, CA",151617,0,0,"2017-12","2017"," CA","Ventura","06111","Ventura",56338,6921,6921,56338,207955,177,141,128,128,137,130
"1499","2712","VENTURA, CA",17363,0,0,"2018-12","2018"," CA","Ventura","06111","Ventura",1960,125,125,1960,19323,177,141,128,128,137,130
"1500","2712","VENTURA, CA",55697,26927,1034,"2020-12","2020"," CA","Ventura","06111","Ventura",217195,19649,20683,244122,272892,177,141,128,128,137,130
"1501","2712","VENTURA, CA",741268,284456,97130,"2021-12","2021"," CA","Ventura","06111","Ventura",221976,126878,224008,506432,963244,177,141,128,128,137,130
"1502","2015","VICKSBURG, MS",88016,0,0,"2013-12","2013"," MS","Vicksburg","22065","Madison",11086,420,420,11086,99102,176,143,168,168,134,128
"1503","2015","VICKSBURG, MS",140079,0,0,"2014-12","2014"," MS","Vicksburg","22065","Madison",8908,132,132,8908,148987,176,143,168,168,134,128
"1504","2015","VICKSBURG, MS",1328870,0,0,"2015-12","2015"," MS","Vicksburg","22065","Madison",0,0,0,0,1328870,176,143,168,168,134,128
"1505","2015","VICKSBURG, MS",1683054,0,0,"2016-12","2016"," MS","Vicksburg","22065","Madison",46479,1085,1085,46479,1729533,176,143,168,168,134,128
"1506","2015","VICKSBURG, MS",259190,0,0,"2017-12","2017"," MS","Vicksburg","22065","Madison",0,0,0,0,259190,176,143,168,168,134,128
"1507","2015","VICKSBURG, MS",113196,0,0,"2018-12","2018"," MS","Vicksburg","22065","Madison",0,0,0,0,113196,176,143,168,168,134,128
"1508","2015","VICKSBURG, MS",6101,0,0,"2019-12","2019"," MS","Vicksburg","22065","Madison",457313,78886,78886,457313,463414,176,143,168,168,134,128
"1509","2015","VICKSBURG, MS",343750,0,0,"2020-12","2020"," MS","Vicksburg","22065","Madison",92997,25096,25096,92997,436747,176,143,168,168,134,128
"1510","2015","VICKSBURG, MS",184202,0,0,"2021-12","2021"," MS","Vicksburg","22065","Madison",297461,144857,144857,297461,481663,176,143,168,168,134,128
"1511","5401","WASHINGTON, DC",5111609621,1491742,577363,"2013-12","2013"," DC","Washington","51013","Arlington",1493693,188006,765369,2985435,5113103314,39,89,83,91,66,80
"1512","5401","WASHINGTON, DC",5417981236,5339382,2363159,"2014-12","2014"," DC","Washington","51013","Arlington",2735768,2693306,5056465,8075150,5420717004,39,89,83,91,66,80
"1513","5401","WASHINGTON, DC",5055130471,5013755,605071,"2015-12","2015"," DC","Washington","51013","Arlington",2385174,299370,904441,7398929,5057515645,39,89,83,91,66,80
"1514","5401","WASHINGTON, DC",5016575039,1879563,224113,"2016-12","2016"," DC","Washington","51013","Arlington",18098016,10616290,10840403,19977579,5034673055,39,89,83,91,66,80
"1515","5401","WASHINGTON, DC",5845962300,893267,147140,"2017-12","2017"," DC","Washington","51013","Arlington",31647810,8017992,8165132,32541077,5877610110,39,89,83,91,66,80
"1516","5401","WASHINGTON, DC",7297595935,3693188,470473,"2018-12","2018"," DC","Washington","51013","Arlington",27407778,5631716,6102189,31100966,7325003713,39,89,83,91,66,80
"1517","5401","WASHINGTON, DC",7553511668,1421121,611482,"2019-12","2019"," DC","Washington","51013","Arlington",35304297,7240722,7852204,36725418,7588815965,39,89,83,91,66,80
"1518","5401","WASHINGTON, DC",4518902639,4168401,730461,"2020-12","2020"," DC","Washington","51013","Arlington",20490326,3622972,4353433,24658727,4539392965,39,89,83,91,66,80
"1519","5401","WASHINGTON, DC",7283907345,403854,80284,"2021-12","2021"," DC","Washington","51013","Arlington",30760146,4796841,4877125,31164000,7314667491,39,89,83,91,66,80
"1520","5204","WEST PALM BEACH, FL",1861080016,1266048266,464190164,"2013-12","2013"," FL","West Palm Beach","12099","Palm Beach",303436122,127463071,591653235,1569484388,2164516138,54,28,20,23,38,41
"1521","5204","WEST PALM BEACH, FL",2011663518,1365697018,469266298,"2014-12","2014"," FL","West Palm Beach","12099","Palm Beach",331564190,152200298,621466596,1697261208,2343227708,54,28,20,23,38,41
"1522","5204","WEST PALM BEACH, FL",1792103135,1405761391,486356034,"2015-12","2015"," FL","West Palm Beach","12099","Palm Beach",260340951,117395841,603751875,1666102342,2052444086,54,28,20,23,38,41
"1523","5204","WEST PALM BEACH, FL",1810263244,1372989178,511771269,"2016-12","2016"," FL","West Palm Beach","12099","Palm Beach",226683059,104862093,616633362,1599672237,2036946303,54,28,20,23,38,41
"1524","5204","WEST PALM BEACH, FL",1775795133,1505322468,553666684,"2017-12","2017"," FL","West Palm Beach","12099","Palm Beach",243974563,112115005,665781689,1749297031,2019769696,54,28,20,23,38,41
"1525","5204","WEST PALM BEACH, FL",2004762642,1624730833,534678778,"2018-12","2018"," FL","West Palm Beach","12099","Palm Beach",236321436,121791888,656470666,1861052269,2241084078,54,28,20,23,38,41
"1526","5204","WEST PALM BEACH, FL",2012924479,1583333729,519561106,"2019-12","2019"," FL","West Palm Beach","12099","Palm Beach",232221146,107126153,626687259,1815554875,2245145625,54,28,20,23,38,41
"1527","5204","WEST PALM BEACH, FL",1642058532,1380286230,500609376,"2020-12","2020"," FL","West Palm Beach","12099","Palm Beach",239028011,113392582,614001958,1619314241,1881086543,54,28,20,23,38,41
"1528","5204","WEST PALM BEACH, FL",2107563729,1747413329,600026976,"2021-12","2021"," FL","West Palm Beach","12099","Palm Beach",346095910,164804584,764831560,2093509239,2453659639,54,28,20,23,38,41
"1529","1103","WILMINGTON, DE",3003071377,302688665,188385837,"2013-12","2013"," DE","Wilmington","34033","Salem",700883327,1170926397,1359312234,1003571992,3703954704,44,19,23,30,25,17
"1530","1103","WILMINGTON, DE",3192914120,294406645,204689811,"2014-12","2014"," DE","Wilmington","34033","Salem",730928436,1157353374,1362043185,1025335081,3923842556,44,19,23,30,25,17
"1531","1103","WILMINGTON, DE",3166068064,296651411,200730721,"2015-12","2015"," DE","Wilmington","34033","Salem",728242663,1314739909,1515470630,1024894074,3894310727,44,19,23,30,25,17
"1532","1103","WILMINGTON, DE",3058762128,882633428,282214057,"2016-12","2016"," DE","Wilmington","34033","Salem",806239721,1336815216,1619029273,1688873149,3865001849,44,19,23,30,25,17
"1533","1103","WILMINGTON, DE",3104766083,1015613295,360236262,"2017-12","2017"," DE","Wilmington","34033","Salem",749415363,1167106964,1527343226,1765028658,3854181446,44,19,23,30,25,17
"1534","1103","WILMINGTON, DE",3538747675,987058750,351613169,"2018-12","2018"," DE","Wilmington","34033","Salem",834082952,1490518706,1842131875,1821141702,4372830627,44,19,23,30,25,17
"1535","1103","WILMINGTON, DE",4518210696,1206699007,367799246,"2019-12","2019"," DE","Wilmington","34033","Salem",1066284056,1902687613,2270486859,2272983063,5584494752,44,19,23,30,25,17
"1536","1103","WILMINGTON, DE",2873356539,926304099,378795455,"2020-12","2020"," DE","Wilmington","34033","Salem",1091889704,1925806646,2304602101,2018193803,3965246243,44,19,23,30,25,17
"1537","1103","WILMINGTON, DE",2923513796,1171219699,359403107,"2021-12","2021"," DE","Wilmington","34033","Salem",1162193738,1845579283,2204982390,2333413437,4085707534,44,19,23,30,25,17
"1538","1501","WILMINGTON, NC",3812843375,2226343950,989223455,"2013-12","2013"," NC","Wilmington","37129","New Hanover",3944024312,1097364024,2086587479,6170368262,7756867687,30,18,15,16,20,20
"1539","1501","WILMINGTON, NC",3794979632,2653871810,955235744,"2014-12","2014"," NC","Wilmington","37129","New Hanover",4135978073,1112678636,2067914380,6789849883,7930957705,30,18,15,16,20,20
"1540","1501","WILMINGTON, NC",3755850297,2612091111,8.88e+08,"2015-12","2015"," NC","Wilmington","37129","New Hanover",4397490322,1213182133,2101182120,7009581433,8153340619,30,18,15,16,20,20
"1541","1501","WILMINGTON, NC",4273009967,3533870837,936398026,"2016-12","2016"," NC","Wilmington","37129","New Hanover",3508962307,919414495,1855812521,7042833144,7781972274,30,18,15,16,20,20
"1542","1501","WILMINGTON, NC",4459870141,3780776851,1115230769,"2017-12","2017"," NC","Wilmington","37129","New Hanover",2696832959,703037743,1818268512,6477609810,7156703100,30,18,15,16,20,20
"1543","1501","WILMINGTON, NC",5329590576,4742730262,1410991799,"2018-12","2018"," NC","Wilmington","37129","New Hanover",3785077388,1070458208,2481450007,8527807650,9114667964,30,18,15,16,20,20
"1544","1501","WILMINGTON, NC",5937210994,5264674907,1280654491,"2019-12","2019"," NC","Wilmington","37129","New Hanover",4196862184,902769413,2183423904,9461537091,10134073178,30,18,15,16,20,20
"1545","1501","WILMINGTON, NC",4014945120,3320663858,1273976736,"2020-12","2020"," NC","Wilmington","37129","New Hanover",4004428457,937094443,2211071179,7325092315,8019373577,30,18,15,16,20,20
"1546","1501","WILMINGTON, NC",4949252750,4365687419,1418602102,"2021-12","2021"," NC","Wilmington","37129","New Hanover",4627292072,1212040083,2630642185,8992979491,9576544822,30,18,15,16,20,20
"1547","1502","WINSTON-SALEM, NC",33158691,0,0,"2013-12","2013"," NC","Winston-Salem","37067","Forsyth",0,0,0,0,33158691,116,172.5,168,168,170,170
"1548","1502","WINSTON-SALEM, NC",21019489,0,0,"2014-12","2014"," NC","Winston-Salem","37067","Forsyth",0,0,0,0,21019489,116,172.5,168,168,170,170
"1549","1502","WINSTON-SALEM, NC",24403898,0,0,"2015-12","2015"," NC","Winston-Salem","37067","Forsyth",0,0,0,0,24403898,116,172.5,168,168,170,170
"1550","1502","WINSTON-SALEM, NC",146934861,0,0,"2016-12","2016"," NC","Winston-Salem","37067","Forsyth",0,0,0,0,146934861,116,172.5,168,168,170,170
"1551","1502","WINSTON-SALEM, NC",11873278,0,0,"2017-12","2017"," NC","Winston-Salem","37067","Forsyth",0,0,0,0,11873278,116,172.5,168,168,170,170
"1552","1502","WINSTON-SALEM, NC",13218814,0,0,"2018-12","2018"," NC","Winston-Salem","37067","Forsyth",0,0,0,0,13218814,116,172.5,168,168,170,170
"1553","1502","WINSTON-SALEM, NC",35915828,0,0,"2019-12","2019"," NC","Winston-Salem","37067","Forsyth",0,0,0,0,35915828,116,172.5,168,168,170,170
"1554","1502","WINSTON-SALEM, NC",14377098,0,0,"2020-12","2020"," NC","Winston-Salem","37067","Forsyth",0,0,0,0,14377098,116,172.5,168,168,170,170
"1555","1502","WINSTON-SALEM, NC",35693053,0,0,"2021-12","2021"," NC","Winston-Salem","37067","Forsyth",0,0,0,0,35693053,116,172.5,168,168,170,170
"1556","0403","WORCESTER, MA",1464154,0,0,"2013-12","2013"," MA","Worcester","25027","Worcester",0,0,0,0,1464154,115,132,105,112,170,170
"1557","0403","WORCESTER, MA",1826606,0,0,"2014-12","2014"," MA","Worcester","25027","Worcester",0,0,0,0,1826606,115,132,105,112,170,170
"1558","0403","WORCESTER, MA",1881867,69283,26651,"2015-12","2015"," MA","Worcester","25027","Worcester",0,0,26651,69283,1881867,115,132,105,112,170,170
"1559","0403","WORCESTER, MA",1445321,1018629,236895,"2016-12","2016"," MA","Worcester","25027","Worcester",0,0,236895,1018629,1445321,115,132,105,112,170,170
"1560","0403","WORCESTER, MA",43306926,2654271,123324,"2017-12","2017"," MA","Worcester","25027","Worcester",0,0,123324,2654271,43306926,115,132,105,112,170,170
"1561","0403","WORCESTER, MA",71552418,249269,251036,"2018-12","2018"," MA","Worcester","25027","Worcester",0,0,251036,249269,71552418,115,132,105,112,170,170
"1562","0403","WORCESTER, MA",708302,0,0,"2019-12","2019"," MA","Worcester","25027","Worcester",0,0,0,0,708302,115,132,105,112,170,170
"1563","0403","WORCESTER, MA",68077768,0,0,"2020-12","2020"," MA","Worcester","25027","Worcester",0,0,0,0,68077768,115,132,105,112,170,170
"1564","0403","WORCESTER, MA",156649012,0,0,"2021-12","2021"," MA","Worcester","25027","Worcester",0,0,0,0,156649012,115,132,105,112,170,170
"1565","3105","WRANGELL, AK",10162004,9601483,5115078,"2013-12","2013"," AK","Wrangell","02275","Wrangell",0,0,5115078,9601483,10162004,152,96,72,78,144,151
"1566","3105","WRANGELL, AK",14991849,14892103,9288413,"2014-12","2014"," AK","Wrangell","02275","Wrangell",0,0,9288413,14892103,14991849,152,96,72,78,144,151
"1567","3105","WRANGELL, AK",13446876,13394008,7174793,"2015-12","2015"," AK","Wrangell","02275","Wrangell",5622,915,7175708,13399630,13452498,152,96,72,78,144,151
"1568","3105","WRANGELL, AK",8921101,8711622,4268509,"2016-12","2016"," AK","Wrangell","02275","Wrangell",0,0,4268509,8711622,8921101,152,96,72,78,144,151
"1569","3105","WRANGELL, AK",2396807,2198607,655677,"2017-12","2017"," AK","Wrangell","02275","Wrangell",6052,4497,660174,2204659,2402859,152,96,72,78,144,151
"1570","3105","WRANGELL, AK",768341,717639,293735,"2018-12","2018"," AK","Wrangell","02275","Wrangell",0,0,293735,717639,768341,152,96,72,78,144,151
"1571","3105","WRANGELL, AK",355177,290680,155775,"2019-12","2019"," AK","Wrangell","02275","Wrangell",176240,2399,158174,466920,531417,152,96,72,78,144,151
"1572","3105","WRANGELL, AK",526352,0,0,"2020-12","2020"," AK","Wrangell","02275","Wrangell",0,0,0,0,526352,152,96,72,78,144,151
"1573","3105","WRANGELL, AK",1354245,0,0,"2021-12","2021"," AK","Wrangell","02275","Wrangell",0,0,0,0,1354245,152,96,72,78,144,151
"1574","0000","STATE TOTAL",15223678162,111080356,48514245,NA,"2013"," AK","State Total","","State Total",35637669,36076485,84590730,146718025,15259315831,15,19,14,16,26,28
"1575","0000","STATE TOTAL",6965082800,1375025768,1411895979,NA,"2013"," AL","State Total","","State Total",3083242873,1423764531,2835660510,4458268641,10048325673,16,12,13,11,12,13
"1576","0000","STATE TOTAL",107305463314,75728130724,32204477611,NA,"2013"," CA","State Total","","State Total",306798477678,50796396282,83000873893,382526608402,414103940992,1,1,1,1,1,1
"1577","0000","STATE TOTAL",364020385,30050,6888,NA,"2013"," CT","State Total","","State Total",627621,644468,651356,657671,364648006,29,27,30,28,28,26
"1578","0000","STATE TOTAL",5111609621,1491742,577363,NA,"2013"," DC","State Total","","State Total",1493693,188006,765369,2985435,5113103314,19,30,29,30,29,30
"1579","0000","STATE TOTAL",3003071377,302688665,188385837,NA,"2013"," DE","State Total","","State Total",700883327,1170926397,1359312234,1003571992,3703954704,24,15,17,18,16,12
"1580","0000","STATE TOTAL",44096377402,20958598310,5216065059,NA,"2013"," FL","State Total","","State Total",25741609503,7036217844,12252282903,46700207813,69837986905,10,6,4,8,7,4
"1581","0000","STATE TOTAL",47567041253,20245903839,10898202846,NA,"2013"," GA","State Total","","State Total",40260124079,8590815427,19489018273,60506027918,87827165332,5,3,6,3,2,2
"1582","0000","STATE TOTAL",372214382,102257839,175559857,NA,"2013"," HI","State Total","","State Total",478167226,156745694,332305551,580425065,850381608,25,17,23,19,19,17
"1583","0000","STATE TOTAL",40021756303,68480057,40155933,NA,"2013"," IL","State Total","","State Total",457854824,89081871,129237804,526334881,40479611127,11,22,21,22,20,19
"1584","0000","STATE TOTAL",468398,0,0,NA,"2013"," IN","State Total","","State Total",0,0,0,0,468398,31,31,31,31,31,31
"1585","0000","STATE TOTAL",90929467171,4752269076,2566053964,NA,"2013"," LA","State Total","","State Total",6183528023,3891634611,6457688575,10935797099,9.7113e+10,6,9,9,9,11,10
"1586","0000","STATE TOTAL",1246085779,707864702,466305216,NA,"2013"," MA","State Total","","State Total",3632128463,834403504,1300708720,4339993165,4878214242,22,16,16,15,13,15
"1587","0000","STATE TOTAL",21040628563,4866780074,1503628329,NA,"2013"," MD","State Total","","State Total",15370487303,3666025032,5169653361,20237267377,36411115866,13,10,10,10,8,8
"1588","0000","STATE TOTAL",4049123327,86614458,87764650,NA,"2013"," ME","State Total","","State Total",161344609,45449172,133213822,247959067,4210467936,23,23,20,23,21,20
"1589","0000","STATE TOTAL",128638132418,1131275483,204494837,NA,"2013"," MI","State Total","","State Total",325013401,139730584,344225421,1456288884,128963145819,3,21,18,21,23,23
"1590","0000","STATE TOTAL",8311077120,252128860,216161091,NA,"2013"," MN","State Total","","State Total",524616370,126944232,343105323,776745230,8835693490,18,20,22,20,18,21
"1591","0000","STATE TOTAL",5798727970,617303398,549697045,NA,"2013"," MS","State Total","","State Total",1272074312,771363578,1321060623,1889377710,7070802282,20,14,15,13,15,16
"1592","0000","STATE TOTAL",5420746021,2226907350,994325290,NA,"2013"," NC","State Total","","State Total",4255891588,1226763270,2221088560,6482798938,9676637609,17,13,12,12,14,14
"1593","0000","STATE TOTAL",584179813,64975518,45998849,NA,"2013"," NH","State Total","","State Total",37753553,9526255,55525104,102729071,621933366,28,26,24,26,27,25
"1594","0000","STATE TOTAL",1161473662,41796041,2493408,NA,"2013"," NJ","State Total","","State Total",3602382,2352251,4845659,45398423,1165076044,30,29,25,24,30,29
"1595","0000","STATE TOTAL",92552202429,28614817883,7317145596,NA,"2013"," NY","State Total","","State Total",8869748288,2480352252,9797497848,37484566171,1.01422e+11,7,8,3,5,10,11
"1596","0000","STATE TOTAL",31254337054,11055602,2794883,NA,"2013"," OH","State Total","","State Total",41733698,49801720,52596603,52789300,31296070752,12,25,26,25,24,24
"1597","0000","STATE TOTAL",4660560892,797008472,757993746,NA,"2013"," OR","State Total","","State Total",2155927769,1131769585,1889763331,2952936241,6816488661,21,18,19,17,17,18
"1598","0000","STATE TOTAL",7164127925,3163575272,679438931,NA,"2013"," PA","State Total","","State Total",9128514162,2938583201,3618022132,12292089434,16292642087,14,11,11,14,9,9
"1599","0000","STATE TOTAL",330708842,821217,113158,NA,"2013"," RI","State Total","","State Total",584307643,28202927,28316085,585128860,915016485,27,24,28,27,22,22
"1600","0000","STATE TOTAL",25904818569,13850745146,4648906712,NA,"2013"," SC","State Total","","State Total",37985238127,5251402316,9900309028,51835983273,63890056696,8,7,7,7,5,7
"1601","0000","STATE TOTAL",133778842944,30783793526,14624255731,NA,"2013"," TX","State Total","","State Total",26477741960,10133711445,24757967176,57261535486,160256584904,2,2,2,2,6,3
"1602","0000","STATE TOTAL",29724723571,19995312241,6896147205,NA,"2013"," VA","State Total","","State Total",34915916870,7091428600,13987575805,54911229111,64640640441,9,5,5,6,4,5
"1603","0000","STATE TOTAL",75492037802,13499754047,9652874356,NA,"2013"," WA","State Total","","State Total",54437058609,8681149635,18334023991,67936812656,129929096411,4,4,8,4,3,6
"1604","0000","STATE TOTAL",638831388,2557581,361981,NA,"2013"," WI","State Total","","State Total",41997499,24015026,24377007,44555080,680828887,26,28,27,29,25,27
"1605","0000","STATE TOTAL",138874,0,0,NA,"2013"," WV","State Total","","State Total",0,0,0,0,138874,32,32,32,32,32,32
"1606","0000","STATE TOTAL",17723989212,1916337222,747683820,NA,"2014"," AK","State Total","","State Total",38588801,42106858,789790678,1954926023,17762578013,15,19,14,16,26,28
"1607","0000","STATE TOTAL",6913571391,1486118420,1499133226,NA,"2014"," AL","State Total","","State Total",2837626583,998538874,2497672100,4323745003,9751197974,16,12,13,11,12,13
"1608","0000","STATE TOTAL",105734577482,77515983618,32395051400,NA,"2014"," CA","State Total","","State Total",311497876700,53968353568,86363404968,389013860318,417232454182,1,1,1,1,1,1
"1609","0000","STATE TOTAL",461024789,176844,91837,NA,"2014"," CT","State Total","","State Total",12813027,17613561,17705398,12989871,473837816,29,27,30,28,28,26
"1610","0000","STATE TOTAL",5417981236,5339382,2363159,NA,"2014"," DC","State Total","","State Total",2735768,2693306,5056465,8075150,5420717004,19,30,29,30,29,30
"1611","0000","STATE TOTAL",3192914120,294406645,204689811,NA,"2014"," DE","State Total","","State Total",730928436,1157353374,1362043185,1025335081,3923842556,24,15,17,18,16,12
"1612","0000","STATE TOTAL",42534945869,21703260589,5231516333,NA,"2014"," FL","State Total","","State Total",27782025047,7766735568,12998251901,49485285636,70316970916,10,6,4,8,7,4
"1613","0000","STATE TOTAL",49223125348,20715961932,11458929375,NA,"2014"," GA","State Total","","State Total",48727506287,9948784131,21407713506,69443468219,97950631635,5,3,6,3,2,2
"1614","0000","STATE TOTAL",902928821,138343425,164730333,NA,"2014"," HI","State Total","","State Total",479361033,154815501,319545834,617704458,1382289854,25,17,23,19,19,17
"1615","0000","STATE TOTAL",44079792053,104290956,36225563,NA,"2014"," IL","State Total","","State Total",617258094,240969959,277195522,721549050,44697050147,11,22,21,22,20,19
"1616","0000","STATE TOTAL",92608,0,0,NA,"2014"," IN","State Total","","State Total",11904,2,2,11904,104512,31,31,31,31,31,31
"1617","0000","STATE TOTAL",95534379065,4996089433,2905802664,NA,"2014"," LA","State Total","","State Total",6047332762,4547787213,7453589877,11043422195,101581711827,6,9,9,9,11,10
"1618","0000","STATE TOTAL",1217795600,746068662,475843518,NA,"2014"," MA","State Total","","State Total",3804309448,1018990266,1494833784,4550378110,5022105048,22,16,16,15,13,15
"1619","0000","STATE TOTAL",18638661382,4775290638,1441846129,NA,"2014"," MD","State Total","","State Total",16280546868,4016984520,5458830649,21055837506,34919208250,13,10,10,10,8,8
"1620","0000","STATE TOTAL",4702573304,63839462,22793903,NA,"2014"," ME","State Total","","State Total",273227084,110869226,133663129,337066546,4975800388,23,23,20,23,21,20
"1621","0000","STATE TOTAL",1.30865e+11,620652142,101021007,NA,"2014"," MI","State Total","","State Total",251087157,61968673,162989680,871739299,131116061483,3,21,18,21,23,23
"1622","0000","STATE TOTAL",7370052738,146980899,141908591,NA,"2014"," MN","State Total","","State Total",676626104,141175335,283083926,823607003,8046678842,18,20,22,20,18,21
"1623","0000","STATE TOTAL",5110866461,640884290,531729795,NA,"2014"," MS","State Total","","State Total",1280462058,1035784652,1567514447,1921346348,6391328519,20,14,15,13,15,16
"1624","0000","STATE TOTAL",5261532550,2654311367,957344544,NA,"2014"," NC","State Total","","State Total",4371852289,1249920859,2207265403,7026163656,9633384839,17,13,12,12,14,14
"1625","0000","STATE TOTAL",223237971,24786161,16829784,NA,"2014"," NH","State Total","","State Total",43477834,7714141,24543925,68263995,266715805,28,26,24,26,27,25
"1626","0000","STATE TOTAL",816886297,85451801,4697554,NA,"2014"," NJ","State Total","","State Total",7017794,6862086,11559640,92469595,823904091,30,29,25,24,30,29
"1627","0000","STATE TOTAL",97683799022,28672576619,7060096494,NA,"2014"," NY","State Total","","State Total",9942118801,2774159259,9834255753,38614695420,107625917823,7,8,3,5,10,11
"1628","0000","STATE TOTAL",31649977091,86191675,51254053,NA,"2014"," OH","State Total","","State Total",46617470,66855079,118109132,132809145,31696594561,12,25,26,25,24,24
"1629","0000","STATE TOTAL",5487316010,623279812,544807102,NA,"2014"," OR","State Total","","State Total",1961778610,1000367401,1545174503,2585058422,7449094620,21,18,19,17,17,18
"1630","0000","STATE TOTAL",7475897888,3578011867,814892881,NA,"2014"," PA","State Total","","State Total",10942219498,3251812395,4066705276,14520231365,18418117386,14,11,11,14,9,9
"1631","0000","STATE TOTAL",465674719,885296,97278,NA,"2014"," RI","State Total","","State Total",2624567,102755,200033,3509863,468299286,27,24,28,27,22,22
"1632","0000","STATE TOTAL",30431828009,14594639357,5064419883,NA,"2014"," SC","State Total","","State Total",41919202122,6177242935,11241662818,56513841479,72351030131,8,7,7,7,5,7
"1633","0000","STATE TOTAL",136318241216,31259714938,13115452415,NA,"2014"," TX","State Total","","State Total",29124863852,10504312405,23619764820,60384578790,165443105068,2,2,2,2,6,3
"1634","0000","STATE TOTAL",30774708431,21687487680,7270019255,NA,"2014"," VA","State Total","","State Total",38845214479,7730039746,15000059001,60532702159,69619922910,9,5,5,6,4,5
"1635","0000","STATE TOTAL",79863080088,12854915964,9342851571,NA,"2014"," WA","State Total","","State Total",50955172456,8719058713,18061910284,63810088420,130818252544,4,4,8,4,3,6
"1636","0000","STATE TOTAL",702238918,3106231,105941,NA,"2014"," WI","State Total","","State Total",51220173,20691708,20797649,54326404,753459091,26,28,27,29,25,27
"1637","0000","STATE TOTAL",822238,0,0,NA,"2014"," WV","State Total","","State Total",0,0,0,0,822238,32,32,32,32,32,32
"1638","0000","STATE TOTAL",18566287709,2028376399,785394082,NA,"2015"," AK","State Total","","State Total",50338995,44312337,829706419,2078715394,18616626704,15,19,14,16,26,28
"1639","0000","STATE TOTAL",6311102886,1311961581,1271205372,NA,"2015"," AL","State Total","","State Total",3512570972,1255796308,2527001680,4824532553,9823673858,16,12,13,11,12,13
"1640","0000","STATE TOTAL",86044458293,64043203410,27829169593,NA,"2015"," CA","State Total","","State Total",293179908714,54615240115,82444409708,357223112124,379224367007,1,1,1,1,1,1
"1641","0000","STATE TOTAL",373040097,127147,20290,NA,"2015"," CT","State Total","","State Total",18899187,73892645,73912935,19026334,391939284,29,27,30,28,28,26
"1642","0000","STATE TOTAL",5055130471,5013755,605071,NA,"2015"," DC","State Total","","State Total",2385174,299370,904441,7398929,5057515645,19,30,29,30,29,30
"1643","0000","STATE TOTAL",3166068064,296651411,200730721,NA,"2015"," DE","State Total","","State Total",728242663,1314739909,1515470630,1024894074,3894310727,24,15,17,18,16,12
"1644","0000","STATE TOTAL",39301772290,20684819621,5417035380,NA,"2015"," FL","State Total","","State Total",29172007956,11027034341,16444069721,49856827577,68473780246,10,6,4,8,7,4
"1645","0000","STATE TOTAL",47648877218,18464314365,10792414346,NA,"2015"," GA","State Total","","State Total",58219580542,11395850558,22188264904,76683894907,105868457760,5,3,6,3,2,2
"1646","0000","STATE TOTAL",790959555,108453209,130559828,NA,"2015"," HI","State Total","","State Total",475209600,182097116,312656944,583662809,1266169155,25,17,23,19,19,17
"1647","0000","STATE TOTAL",46411357045,115764033,36216740,NA,"2015"," IL","State Total","","State Total",582555999,273558314,309775054,698320032,46993913044,11,22,21,22,20,19
"1648","0000","STATE TOTAL",12035,4800,2005,NA,"2015"," IN","State Total","","State Total",2220,1,2006,7020,14255,31,31,31,31,31,31
"1649","0000","STATE TOTAL",80422889131,5016323342,3600946327,NA,"2015"," LA","State Total","","State Total",5385535434,4262201910,7863148237,10401858776,85808424565,6,9,9,9,11,10
"1650","0000","STATE TOTAL",1020968680,632302800,488619148,NA,"2015"," MA","State Total","","State Total",4095672588,1124567053,1613186201,4727975388,5116641268,22,16,16,15,13,15
"1651","0000","STATE TOTAL",15381871059,4834647645,1439739134,NA,"2015"," MD","State Total","","State Total",16099112196,4536417504,5976156638,20933759841,31480983255,13,10,10,10,8,8
"1652","0000","STATE TOTAL",3674335968,115790541,47773951,NA,"2015"," ME","State Total","","State Total",280491422,74736384,122510335,396281963,3954827390,23,23,20,23,21,20
"1653","0000","STATE TOTAL",118611766424,430771069,78982608,NA,"2015"," MI","State Total","","State Total",236583973,68182987,147165595,667355042,118848350397,3,21,18,21,23,23
"1654","0000","STATE TOTAL",6828889743,132225105,121769372,NA,"2015"," MN","State Total","","State Total",774511476,169405572,291174944,906736581,7603401219,18,20,22,20,18,21
"1655","0000","STATE TOTAL",4269965457,703752319,651922805,NA,"2015"," MS","State Total","","State Total",1385562553,919114480,1571037285,2089314872,5655528010,20,14,15,13,15,16
"1656","0000","STATE TOTAL",5101489391,2612148095,888018588,NA,"2015"," NC","State Total","","State Total",4590133383,1376486443,2264505031,7202281478,9691622774,17,13,12,12,14,14
"1657","0000","STATE TOTAL",367390424,95733126,9453967,NA,"2015"," NH","State Total","","State Total",21287610,4504780,13958747,117020736,388678034,28,26,24,26,27,25
"1658","0000","STATE TOTAL",380276214,9234635,5398322,NA,"2015"," NJ","State Total","","State Total",23618087,32241781,37640103,32852722,403894301,30,29,25,24,30,29
"1659","0000","STATE TOTAL",92290479016,27606064297,7178081620,NA,"2015"," NY","State Total","","State Total",8940168984,2767856121,9945937741,36546233281,101230648000,7,8,3,5,10,11
"1660","0000","STATE TOTAL",32079854715,41439966,10208649,NA,"2015"," OH","State Total","","State Total",128878005,33114048,43322697,170317971,32208732720,12,25,26,25,24,24
"1661","0000","STATE TOTAL",3947978760,156652557,181989872,NA,"2015"," OR","State Total","","State Total",310311328,133821939,315811811,466963885,4258290088,21,18,19,17,17,18
"1662","0000","STATE TOTAL",6259681299,3487290008,835879774,NA,"2015"," PA","State Total","","State Total",11686387357,3606819788,4442699562,15173677365,17946068656,14,11,11,14,9,9
"1663","0000","STATE TOTAL",240416303,860463,86893,NA,"2015"," RI","State Total","","State Total",26542804,2358852,2445745,27403267,266959107,27,24,28,27,22,22
"1664","0000","STATE TOTAL",31634633181,15111239416,5456170714,NA,"2015"," SC","State Total","","State Total",45258821705,7129933233,12586103947,60370061121,76893454886,8,7,7,7,5,7
"1665","0000","STATE TOTAL",112096756153,31456925882,14809969229,NA,"2015"," TX","State Total","","State Total",31677471166,11112660428,25922629657,63134397048,143774227319,2,2,2,2,6,3
"1666","0000","STATE TOTAL",28785078318,20327006209,7215191156,NA,"2015"," VA","State Total","","State Total",41029738965,8349903132,15565094288,61356745174,69814817283,9,5,5,6,4,5
"1667","0000","STATE TOTAL",77207857377,12184467409,8834311781,NA,"2015"," WA","State Total","","State Total",53155117307,8829892775,17664204556,65339584716,1.30363e+11,4,4,8,4,3,6
"1668","0000","STATE TOTAL",698503181,4547772,676262,NA,"2015"," WI","State Total","","State Total",110263603,16143015,16819277,114811375,808766784,26,28,27,29,25,27
"1669","0000","STATE TOTAL",12644,0,0,NA,"2015"," WV","State Total","","State Total",0,0,0,0,12644,32,32,32,32,32,32
"1670","0000","STATE TOTAL",18599703464,1911205709,748235870,NA,"2016"," AK","State Total","","State Total",46129700,45710960,793946830,1957335409,18645833164,15,19,14,16,26,28
"1671","0000","STATE TOTAL",6377547853,1595759142,1396133429,NA,"2016"," AL","State Total","","State Total",3697759745,1285280023,2681413452,5293518887,10075307598,16,12,13,11,12,13
"1672","0000","STATE TOTAL",89991345776,69427052594,33551560184,NA,"2016"," CA","State Total","","State Total",296931260742,54945859304,88497419488,366358313336,386922606518,1,1,1,1,1,1
"1673","0000","STATE TOTAL",402095046,342812,85506,NA,"2016"," CT","State Total","","State Total",20384574,19610951,19696457,20727386,422479620,29,27,30,28,28,26
"1674","0000","STATE TOTAL",5016575039,1879563,224113,NA,"2016"," DC","State Total","","State Total",18098016,10616290,10840403,19977579,5034673055,19,30,29,30,29,30
"1675","0000","STATE TOTAL",3058762128,882633428,282214057,NA,"2016"," DE","State Total","","State Total",806239721,1336815216,1619029273,1688873149,3865001849,24,15,17,18,16,12
"1676","0000","STATE TOTAL",34352835368,21010935894,5701565510,NA,"2016"," FL","State Total","","State Total",29209114961,11325971721,17027537231,50220050855,63561950329,10,6,4,8,7,4
"1677","0000","STATE TOTAL",45808441982,16799738768,10988264636,NA,"2016"," GA","State Total","","State Total",55651922137,11923773518,22912038154,72451660905,101460364119,5,3,6,3,2,2
"1678","0000","STATE TOTAL",492254192,109608511,138678375,NA,"2016"," HI","State Total","","State Total",485442125,170976835,309655210,595050636,977696317,25,17,23,19,19,17
"1679","0000","STATE TOTAL",45483600209,148981370,77829870,NA,"2016"," IL","State Total","","State Total",420483612,241194392,319024262,569464982,45904083821,11,22,21,22,20,19
"1680","0000","STATE TOTAL",9283537,0,0,NA,"2016"," IN","State Total","","State Total",145655,42408,42408,145655,9429192,31,31,31,31,31,31
"1681","0000","STATE TOTAL",79985387313,5180820042,4308774207,NA,"2016"," LA","State Total","","State Total",4623288310,3491368998,7800143205,9804108352,84608675623,6,9,9,9,11,10
"1682","0000","STATE TOTAL",1120844512,750045690,706792103,NA,"2016"," MA","State Total","","State Total",3968380092,999729451,1706521554,4718425782,5089224604,22,16,16,15,13,15
"1683","0000","STATE TOTAL",14065711462,5865549704,1960237063,NA,"2016"," MD","State Total","","State Total",15343160233,4554449732,6514686795,21208709937,29408871695,13,10,10,10,8,8
"1684","0000","STATE TOTAL",4017701620,119979057,33062944,NA,"2016"," ME","State Total","","State Total",363182073,108837665,141900609,483161130,4380883693,23,23,20,23,21,20
"1685","0000","STATE TOTAL",116857923230,689837328,112552346,NA,"2016"," MI","State Total","","State Total",191892746,111768724,224321070,881730074,117049815976,3,21,18,21,23,23
"1686","0000","STATE TOTAL",5998717340,124359898,167603445,NA,"2016"," MN","State Total","","State Total",549878649,126916447,294519892,674238547,6548595989,18,20,22,20,18,21
"1687","0000","STATE TOTAL",3762370734,864560664,838993249,NA,"2016"," MS","State Total","","State Total",1713070353,984453915,1823447164,2577631017,5475441087,20,14,15,13,15,16
"1688","0000","STATE TOTAL",5645452874,3535975837,939427309,NA,"2016"," NC","State Total","","State Total",3696507844,1038028508,1977455817,7232483681,9341960718,17,13,12,12,14,14
"1689","0000","STATE TOTAL",420815229,141849597,6681739,NA,"2016"," NH","State Total","","State Total",28560443,2826412,9508151,170410040,449375672,28,26,24,26,27,25
"1690","0000","STATE TOTAL",387938169,96653897,53934593,NA,"2016"," NJ","State Total","","State Total",2113719,3034713,56969306,98767616,390051888,30,29,25,24,30,29
"1691","0000","STATE TOTAL",86545868996,25480057638,7848414155,NA,"2016"," NY","State Total","","State Total",8098785754,2194241927,10042656082,33578843392,94644654750,7,8,3,5,10,11
"1692","0000","STATE TOTAL",34500283288,30192376,10307111,NA,"2016"," OH","State Total","","State Total",190035646,87999855,98306966,220228022,34690318934,12,25,26,25,24,24
"1693","0000","STATE TOTAL",4062777553,78585841,257926573,NA,"2016"," OR","State Total","","State Total",13518257,2450256,260376829,92104098,4076295810,21,18,19,17,17,18
"1694","0000","STATE TOTAL",6454567444,3386973148,705649968,NA,"2016"," PA","State Total","","State Total",11001173969,3789477435,4495127403,14388147117,17455741413,14,11,11,14,9,9
"1695","0000","STATE TOTAL",180858028,58504,6952,NA,"2016"," RI","State Total","","State Total",77558611,324382234,324389186,77617115,258416639,27,24,28,27,22,22
"1696","0000","STATE TOTAL",33064756440,14427911512,5752803667,NA,"2016"," SC","State Total","","State Total",41877587371,7066260505,12819064172,56305498883,74942343811,8,7,7,7,5,7
"1697","0000","STATE TOTAL",93150432458,26614565481,14320223828,NA,"2016"," TX","State Total","","State Total",28283474089,10605968985,24926192813,54898039570,121433906547,2,2,2,2,6,3
"1698","0000","STATE TOTAL",25991910971,18771931367,7645130721,NA,"2016"," VA","State Total","","State Total",42347015641,8903198538,16548329259,61118947008,68338926612,9,5,5,6,4,5
"1699","0000","STATE TOTAL",72434536074,12233539217,10794566466,NA,"2016"," WA","State Total","","State Total",54443919669,9208137821,20002704287,66677458886,126878455743,4,4,8,4,3,6
"1700","0000","STATE TOTAL",823245898,12222289,777128,NA,"2016"," WI","State Total","","State Total",71669464,16655897,17433025,83891753,894915362,26,28,27,29,25,27
"1701","0000","STATE TOTAL",397725,0,0,NA,"2016"," WV","State Total","","State Total",0,0,0,0,397725,32,32,32,32,32,32
"1702","0000","STATE TOTAL",19711068359,1276492798,458969866,NA,"2017"," AK","State Total","","State Total",35674304,42396919,501366785,1312167102,19746742663,15,19,14,16,26,28
"1703","0000","STATE TOTAL",6577407929,2123188576,1605143131,NA,"2017"," AL","State Total","","State Total",4130817786,1454020465,3059163596,6254006362,10708225715,16,12,13,11,12,13
"1704","0000","STATE TOTAL",95522146851,76250699443,36118180635,NA,"2017"," CA","State Total","","State Total",311659717888,56954276119,93072456754,387910417331,407181864739,1,1,1,1,1,1
"1705","0000","STATE TOTAL",359475054,10344516,37065151,NA,"2017"," CT","State Total","","State Total",16430665,27748058,64813209,26775181,375905719,29,27,30,28,28,26
"1706","0000","STATE TOTAL",5845962300,893267,147140,NA,"2017"," DC","State Total","","State Total",31647810,8017992,8165132,32541077,5877610110,19,30,29,30,29,30
"1707","0000","STATE TOTAL",3104766083,1015613295,360236262,NA,"2017"," DE","State Total","","State Total",749415363,1167106964,1527343226,1765028658,3854181446,24,15,17,18,16,12
"1708","0000","STATE TOTAL",34194809234,22850796618,6190926948,NA,"2017"," FL","State Total","","State Total",31657633537,10203146230,16394073178,54508430155,65852442771,10,6,4,8,7,4
"1709","0000","STATE TOTAL",49148840081,20447270355,12335890465,NA,"2017"," GA","State Total","","State Total",60052215032,12821118765,25157009230,80499485387,109201055113,5,3,6,3,2,2
"1710","0000","STATE TOTAL",634068488,115385980,157662849,NA,"2017"," HI","State Total","","State Total",519703194,924830347,1082493196,635089174,1153771682,25,17,23,19,19,17
"1711","0000","STATE TOTAL",47843118161,141179465,40140764,NA,"2017"," IL","State Total","","State Total",559351344,164754014,204894778,700530809,48402469505,11,22,21,22,20,19
"1712","0000","STATE TOTAL",14443081,167505,4983,NA,"2017"," IN","State Total","","State Total",0,0,4983,167505,14443081,31,31,31,31,31,31
"1713","0000","STATE TOTAL",91584329589,5975009028,4361962595,NA,"2017"," LA","State Total","","State Total",5290276742,3805623813,8167586408,11265285770,96874606331,6,9,9,9,11,10
"1714","0000","STATE TOTAL",1630797473,935074582,839916435,NA,"2017"," MA","State Total","","State Total",4148963861,1063088188,1903004623,5084038443,5779761334,22,16,16,15,13,15
"1715","0000","STATE TOTAL",15886198528,6008824885,2284669472,NA,"2017"," MD","State Total","","State Total",17115813171,5130557378,7415226850,23124638056,33002011699,13,10,10,10,8,8
"1716","0000","STATE TOTAL",3781282952,165358379,36329623,NA,"2017"," ME","State Total","","State Total",349707800,167570587,203900210,515066179,4130990752,23,23,20,23,21,20
"1717","0000","STATE TOTAL",126986629051,770604816,152730338,NA,"2017"," MI","State Total","","State Total",204377662,107646447,260376785,974982478,1.27191e+11,3,21,18,21,23,23
"1718","0000","STATE TOTAL",5954985931,87882736,83880902,NA,"2017"," MN","State Total","","State Total",526082229,121634151,205515053,613964965,6481068160,18,20,22,20,18,21
"1719","0000","STATE TOTAL",4037326094,1304651615,1224044936,NA,"2017"," MS","State Total","","State Total",1632633829,890204476,2114249412,2937285444,5669959923,20,14,15,13,15,16
"1720","0000","STATE TOTAL",6010253189,3781096170,1115516193,NA,"2017"," NC","State Total","","State Total",2823967583,777192595,1892708788,6605063753,8834220772,17,13,12,12,14,14
"1721","0000","STATE TOTAL",995902450,114433457,9222448,NA,"2017"," NH","State Total","","State Total",37684638,64984984,74207432,152118095,1033587088,28,26,24,26,27,25
"1722","0000","STATE TOTAL",129391308,66970188,70007659,NA,"2017"," NJ","State Total","","State Total",2248824,304734,70312393,69219012,131640132,30,29,25,24,30,29
"1723","0000","STATE TOTAL",81955641164,27377929834,8728674308,NA,"2017"," NY","State Total","","State Total",8698367963,2432211081,11160885389,36076297797,90654009127,7,8,3,5,10,11
"1724","0000","STATE TOTAL",39367305605,12567789,4454549,NA,"2017"," OH","State Total","","State Total",258023160,29999662,34454211,270590949,39625328765,12,25,26,25,24,24
"1725","0000","STATE TOTAL",5218562592,36148439,115770561,NA,"2017"," OR","State Total","","State Total",9633528,44130394,159900955,45781967,5228196120,21,18,19,17,17,18
"1726","0000","STATE TOTAL",7659562610,4298797909,802659530,NA,"2017"," PA","State Total","","State Total",12519950041,4019524247,4822183777,16818747950,20179512651,14,11,11,14,9,9
"1727","0000","STATE TOTAL",265062235,17459468,39203707,NA,"2017"," RI","State Total","","State Total",72610022,278118582,317322289,90069490,337672257,27,24,28,27,22,22
"1728","0000","STATE TOTAL",30921810154,15595865757,6607934627,NA,"2017"," SC","State Total","","State Total",42206752259,8283998246,14891932873,57802618016,73128562413,8,7,7,7,5,7
"1729","0000","STATE TOTAL",117365136243,29030929728,15199601018,NA,"2017"," TX","State Total","","State Total",32983382572,12138342443,27337943461,62014312300,150348518815,2,2,2,2,6,3
"1730","0000","STATE TOTAL",27107449898,21345729390,9726215871,NA,"2017"," VA","State Total","","State Total",44345581824,9530559435,19256775306,65691311214,71453031722,9,5,5,6,4,5
"1731","0000","STATE TOTAL",68038793810,12891268762,10943670801,NA,"2017"," WA","State Total","","State Total",54210023437,9007328649,1.9951e+10,67101292199,122248817247,4,4,8,4,3,6
"1732","0000","STATE TOTAL",853243486,54958684,14829973,NA,"2017"," WI","State Total","","State Total",74655246,14646987,29476960,129613930,927898732,26,28,27,29,25,27
"1733","0000","STATE TOTAL",263218,0,0,NA,"2017"," WV","State Total","","State Total",0,0,0,0,263218,32,32,32,32,32,32
"1734","0000","STATE TOTAL",21763303385,1336211881,533488429,NA,"2018"," AK","State Total","","State Total",26044547,46564238,580052667,1362256428,21789347932,15,19,14,16,26,28
"1735","0000","STATE TOTAL",6100472133,2532004978,1653042944,NA,"2018"," AL","State Total","","State Total",4308605633,1216775116,2869818060,6840610611,10409077766,16,12,13,11,12,13
"1736","0000","STATE TOTAL",96851580401,80544169599,38718413292,NA,"2018"," CA","State Total","","State Total",334069572846,59582988805,98301402097,414613742445,430921153247,1,1,1,1,1,1
"1737","0000","STATE TOTAL",296618711,533598,125631,NA,"2018"," CT","State Total","","State Total",23232889,29690219,29815850,23766487,319851600,29,27,30,28,28,26
"1738","0000","STATE TOTAL",7297595935,3693188,470473,NA,"2018"," DC","State Total","","State Total",27407778,5631716,6102189,31100966,7325003713,19,30,29,30,29,30
"1739","0000","STATE TOTAL",3538747675,987058750,351613169,NA,"2018"," DE","State Total","","State Total",834082952,1490518706,1842131875,1821141702,4372830627,24,15,17,18,16,12
"1740","0000","STATE TOTAL",36013286400,23745570189,6294373972,NA,"2018"," FL","State Total","","State Total",33590076619,9967288203,16261662175,57335646808,69603363019,10,6,4,8,7,4
"1741","0000","STATE TOTAL",54170609542,22719017078,13954449805,NA,"2018"," GA","State Total","","State Total",69824161237,14165991515,28120441320,92543178315,123994770779,5,3,6,3,2,2
"1742","0000","STATE TOTAL",730293749,111658409,156056605,NA,"2018"," HI","State Total","","State Total",670406240,1205649886,1361706491,782064649,1400699989,25,17,23,19,19,17
"1743","0000","STATE TOTAL",52238222334,213734472,59542468,NA,"2018"," IL","State Total","","State Total",653994136,142441103,201983571,867728608,52892216470,11,22,21,22,20,19
"1744","0000","STATE TOTAL",9629026,103030,28179,NA,"2018"," IN","State Total","","State Total",841856,214636,242815,944886,10470882,31,31,31,31,31,31
"1745","0000","STATE TOTAL",104203671221,7787525096,4862840207,NA,"2018"," LA","State Total","","State Total",5679268129,3797715137,8660555344,13466793225,109882939350,6,9,9,9,11,10
"1746","0000","STATE TOTAL",1353924972,964713263,834582051,NA,"2018"," MA","State Total","","State Total",4816862988,1128100272,1962682323,5781576251,6170787960,22,16,16,15,13,15
"1747","0000","STATE TOTAL",16811472009,6563653644,2465603000,NA,"2018"," MD","State Total","","State Total",20610478732,5410390883,7875993883,27174132376,37421950741,13,10,10,10,8,8
"1748","0000","STATE TOTAL",3974280436,269191808,117217494,NA,"2018"," ME","State Total","","State Total",500170524,132813376,250030870,769362332,4474450960,23,23,20,23,21,20
"1749","0000","STATE TOTAL",130768153624,735183933,128011110,NA,"2018"," MI","State Total","","State Total",145180031,84658719,212669829,880363964,130913333655,3,21,18,21,23,23
"1750","0000","STATE TOTAL",6141203345,110559155,76055793,NA,"2018"," MN","State Total","","State Total",442949814,112255605,188311398,553508969,6584153159,18,20,22,20,18,21
"1751","0000","STATE TOTAL",4181984320,1336286039,1171353709,NA,"2018"," MS","State Total","","State Total",1436670577,829487171,2000840880,2772956616,5618654897,20,14,15,13,15,16
"1752","0000","STATE TOTAL",7500349190,4743692635,1411017065,NA,"2018"," NC","State Total","","State Total",3964136404,1212629823,2623646888,8707829039,11464485594,17,13,12,12,14,14
"1753","0000","STATE TOTAL",782521358,52326998,11277007,NA,"2018"," NH","State Total","","State Total",7494237,40748760,52025767,59821235,790015595,28,26,24,26,27,25
"1754","0000","STATE TOTAL",80319725,77206988,78409701,NA,"2018"," NJ","State Total","","State Total",813487,43105,78452806,78020475,81133212,30,29,25,24,30,29
"1755","0000","STATE TOTAL",84684574576,31127893739,10392489335,NA,"2018"," NY","State Total","","State Total",8703120259,2580889960,12973379295,39831013998,93387694835,7,8,3,5,10,11
"1756","0000","STATE TOTAL",44525469806,25895644,7690595,NA,"2018"," OH","State Total","","State Total",150753189,156841640,164532235,176648833,44676222995,12,25,26,25,24,24
"1757","0000","STATE TOTAL",5330536685,88283019,325769818,NA,"2018"," OR","State Total","","State Total",36216904,18349360,344119178,124499923,5366753589,21,18,19,17,17,18
"1758","0000","STATE TOTAL",7547763503,4553979636,787793903,NA,"2018"," PA","State Total","","State Total",14025865927,3975842214,4763636117,18579845563,21573629430,14,11,11,14,9,9
"1759","0000","STATE TOTAL",360752423,12200685,33925980,NA,"2018"," RI","State Total","","State Total",58796318,44278237,78204217,70997003,419548741,27,24,28,27,22,22
"1760","0000","STATE TOTAL",3.418e+10,17964075636,7288404615,NA,"2018"," SC","State Total","","State Total",43456496891,7957429510,15245834125,61420572527,77636496098,8,7,7,7,5,7
"1761","0000","STATE TOTAL",158148570812,32083965484,15984481219,NA,"2018"," TX","State Total","","State Total",37760025605,13062021192,29046502411,69843991089,195908596417,2,2,2,2,6,3
"1762","0000","STATE TOTAL",24714837375,21558660807,10720481753,NA,"2018"," VA","State Total","","State Total",47221559250,9703465196,20423946949,68780220057,71936396625,9,5,5,6,4,5
"1763","0000","STATE TOTAL",65830784039,13205796684,11405525943,NA,"2018"," WA","State Total","","State Total",56883897632,9547844648,20953370591,70089694316,122714681671,4,4,8,4,3,6
"1764","0000","STATE TOTAL",860347125,24600298,1720349,NA,"2018"," WI","State Total","","State Total",104908654,32351026,34071375,129508952,965255779,26,28,27,29,25,27
"1765","0000","STATE TOTAL",1472380,0,0,NA,"2018"," WV","State Total","","State Total",0,0,0,0,1472380,32,32,32,32,32,32
"1766","0000","STATE TOTAL",20899390903,1290058159,472925633,NA,"2019"," AK","State Total","","State Total",22456033,40868648,513794281,1312514192,20921846936,15,19,14,16,26,28
"1767","0000","STATE TOTAL",5456424245,2492733379,2780220738,NA,"2019"," AL","State Total","","State Total",5875322147,1537230195,4317450933,8368055526,11331746392,16,12,13,11,12,13
"1768","0000","STATE TOTAL",95294731910,76287991591,36169508861,NA,"2019"," CA","State Total","","State Total",3.06347e+11,55444331510,91613840371,3.82635e+11,401641693424,1,1,1,1,1,1
"1769","0000","STATE TOTAL",323592617,915991,319294,NA,"2019"," CT","State Total","","State Total",11536826,66457308,66776602,12452817,335129443,29,27,30,28,28,26
"1770","0000","STATE TOTAL",7553511668,1421121,611482,NA,"2019"," DC","State Total","","State Total",35304297,7240722,7852204,36725418,7588815965,19,30,29,30,29,30
"1771","0000","STATE TOTAL",4518210696,1206699007,367799246,NA,"2019"," DE","State Total","","State Total",1066284056,1902687613,2270486859,2272983063,5584494752,24,15,17,18,16,12
"1772","0000","STATE TOTAL",35478847797,23497989273,6025990164,NA,"2019"," FL","State Total","","State Total",33041382120,10344764325,16370754489,56539371393,68520229917,10,6,4,8,7,4
"1773","0000","STATE TOTAL",57417968217,24029363879,13590244578,NA,"2019"," GA","State Total","","State Total",73896551100,14864796345,28455040923,97925914979,131314519317,5,3,6,3,2,2
"1774","0000","STATE TOTAL",378143178,117856341,157066499,NA,"2019"," HI","State Total","","State Total",560545920,982425961,1139492460,678402261,938689098,25,17,23,19,19,17
"1775","0000","STATE TOTAL",50398980388,260171237,93995979,NA,"2019"," IL","State Total","","State Total",313112802,107730650,201726629,573284039,50712093190,11,22,21,22,20,19
"1776","0000","STATE TOTAL",219620,35880,19229,NA,"2019"," IN","State Total","","State Total",133599,10982,30211,169479,353219,31,31,31,31,31,31
"1777","0000","STATE TOTAL",102156246389,6990870977,5525069698,NA,"2019"," LA","State Total","","State Total",5893657932,3917978838,9443048536,12884528909,108049904321,6,9,9,9,11,10
"1778","0000","STATE TOTAL",1215469763,924737198,838674950,NA,"2019"," MA","State Total","","State Total",4849616052,1181155033,2019829983,5774353250,6065085815,22,16,16,15,13,15
"1779","0000","STATE TOTAL",14936467504,5867052957,2749883845,NA,"2019"," MD","State Total","","State Total",21034195446,5412430258,8162314103,26901248403,35970662950,13,10,10,10,8,8
"1780","0000","STATE TOTAL",3958263638,291181028,110985748,NA,"2019"," ME","State Total","","State Total",593627370,138437261,249423009,884808398,4551891008,23,23,20,23,21,20
"1781","0000","STATE TOTAL",127450651441,691189015,123507862,NA,"2019"," MI","State Total","","State Total",225840248,171211321,294719183,917029263,127676491689,3,21,18,21,23,23
"1782","0000","STATE TOTAL",5343844337,74069213,102160764,NA,"2019"," MN","State Total","","State Total",410386472,100920507,203081271,484455685,5754230809,18,20,22,20,18,21
"1783","0000","STATE TOTAL",3929212598,1208893094,1117114335,NA,"2019"," MS","State Total","","State Total",1451632595,762820157,1879934492,2660525689,5380845193,20,14,15,13,15,16
"1784","0000","STATE TOTAL",7470511676,5265092795,1280695827,NA,"2019"," NC","State Total","","State Total",4307581827,1009051892,2289747719,9572674622,11778093503,17,13,12,12,14,14
"1785","0000","STATE TOTAL",786467656,37797478,2753849,NA,"2019"," NH","State Total","","State Total",4377716,90782404,93536253,42175194,790845372,28,26,24,26,27,25
"1786","0000","STATE TOTAL",92686831,58177534,64946312,NA,"2019"," NJ","State Total","","State Total",15112,683,64946995,58192646,92701943,30,29,25,24,30,29
"1787","0000","STATE TOTAL",81447328965,29902507156,10154248717,NA,"2019"," NY","State Total","","State Total",9718670544,2935832137,13090080854,39621177700,9.1166e+10,7,8,3,5,10,11
"1788","0000","STATE TOTAL",49591359216,22108859,6467908,NA,"2019"," OH","State Total","","State Total",154486151,139236538,145704446,176595010,49745845367,12,25,26,25,24,24
"1789","0000","STATE TOTAL",4632223458,78431063,294933258,NA,"2019"," OR","State Total","","State Total",72053755,6972385,301905643,150484818,4704277213,21,18,19,17,17,18
"1790","0000","STATE TOTAL",8433952537,4548420874,720809980,NA,"2019"," PA","State Total","","State Total",15019863347,4197042925,4917852905,19568284221,23453815884,14,11,11,14,9,9
"1791","0000","STATE TOTAL",352947866,7255997,1033944,NA,"2019"," RI","State Total","","State Total",70467197,74092221,75126165,77723194,423415063,27,24,28,27,22,22
"1792","0000","STATE TOTAL",40083675669,17932623620,7004011526,NA,"2019"," SC","State Total","","State Total",44882654004,8147918272,15151929798,62815277624,84966329673,8,7,7,7,5,7
"1793","0000","STATE TOTAL",169336291682,33105639784,19617613287,NA,"2019"," TX","State Total","","State Total",39300862522,12844404248,32462017535,72406502306,208637154204,2,2,2,2,6,3
"1794","0000","STATE TOTAL",24845199560,22396685757,8705338323,NA,"2019"," VA","State Total","","State Total",48314603341,9678655804,18383994127,70711289098,73159802901,9,5,5,6,4,5
"1795","0000","STATE TOTAL",60915155137,13115367146,11027941692,NA,"2019"," WA","State Total","","State Total",54946412797,8938956557,19966898249,68061779943,115861567934,4,4,8,4,3,6
"1796","0000","STATE TOTAL",846901927,7206796,1315590,NA,"2019"," WI","State Total","","State Total",34904686,89694371,91009961,42111482,881806613,26,28,27,29,25,27
"1797","0000","STATE TOTAL",235948,0,0,NA,"2019"," WV","State Total","","State Total",0,0,0,0,235948,32,32,32,32,32,32
"1798","0000","STATE TOTAL",19615167104,1036853119,391728602,NA,"2020"," AK","State Total","","State Total",21942348,35625995,427354597,1058795467,19637109452,15,19,14,16,26,28
"1799","0000","STATE TOTAL",4729714553,2132834844,2580150646,NA,"2020"," AL","State Total","","State Total",6451579351,1787083707,4367234353,8584414195,11181293904,16,12,13,11,12,13
"1800","0000","STATE TOTAL",86477915512,72078545055,35801554460,NA,"2020"," CA","State Total","","State Total",300848190161,57208199416,93009753876,372926735216,387326105673,1,1,1,1,1,1
"1801","0000","STATE TOTAL",399636728,1155494,95913,NA,"2020"," CT","State Total","","State Total",12097690,130292812,130388725,13253184,411734418,29,27,30,28,28,26
"1802","0000","STATE TOTAL",4518902639,4168401,730461,NA,"2020"," DC","State Total","","State Total",20490326,3622972,4353433,24658727,4539392965,19,30,29,30,29,30
"1803","0000","STATE TOTAL",2873356539,926304099,378795455,NA,"2020"," DE","State Total","","State Total",1091889704,1925806646,2304602101,2018193803,3965246243,24,15,17,18,16,12
"1804","0000","STATE TOTAL",27470299603,19014698313,5198131300,NA,"2020"," FL","State Total","","State Total",30027739727,10302100784,15500232084,49042438040,57498039330,10,6,4,8,7,4
"1805","0000","STATE TOTAL",50614837311,22841757778,13872822856,NA,"2020"," GA","State Total","","State Total",73903516057,15093438092,28966260948,96745273835,124518353368,5,3,6,3,2,2
"1806","0000","STATE TOTAL",164527218,98379081,127205941,NA,"2020"," HI","State Total","","State Total",438814196,1001899005,1129104946,537193277,603341414,25,17,23,19,19,17
"1807","0000","STATE TOTAL",53420237068,175692636,91246076,NA,"2020"," IL","State Total","","State Total",275227130,187413072,278659148,450919766,53695464198,11,22,21,22,20,19
"1808","0000","STATE TOTAL",138558,13216,3369,NA,"2020"," IN","State Total","","State Total",828,217,3586,14044,139386,31,31,31,31,31,31
"1809","0000","STATE TOTAL",93412991590,6204920001,5002496903,NA,"2020"," LA","State Total","","State Total",5234038216,3428178077,8430674980,11438958217,98647029806,6,9,9,9,11,10
"1810","0000","STATE TOTAL",1196321260,820297446,888185157,NA,"2020"," MA","State Total","","State Total",4473548395,1086440658,1974625815,5293845841,5669869655,22,16,16,15,13,15
"1811","0000","STATE TOTAL",12674599488,5645872309,2496251675,NA,"2020"," MD","State Total","","State Total",18268267635,5327461617,7823713292,23914139944,30942867123,13,10,10,10,8,8
"1812","0000","STATE TOTAL",3457574784,274393090,45010407,NA,"2020"," ME","State Total","","State Total",622337585,167915557,212925964,896730675,4079912369,23,23,20,23,21,20
"1813","0000","STATE TOTAL",109432462196,573155813,104307850,NA,"2020"," MI","State Total","","State Total",223765516,167654178,271962028,796921329,109656227712,3,21,18,21,23,23
"1814","0000","STATE TOTAL",4058801766,97639634,202217305,NA,"2020"," MN","State Total","","State Total",393203545,91913381,294130686,490843179,4452005311,18,20,22,20,18,21
"1815","0000","STATE TOTAL",2811086291,894760762,993570180,NA,"2020"," MS","State Total","","State Total",1032622454,808568494,1802138674,1927383216,3843708745,20,14,15,13,15,16
"1816","0000","STATE TOTAL",4568224440,3320663858,1273976736,NA,"2020"," NC","State Total","","State Total",4084362438,997696409,2271673145,7405026296,8652586878,17,13,12,12,14,14
"1817","0000","STATE TOTAL",179248217,1464610,818192,NA,"2020"," NH","State Total","","State Total",2879876,151201051,152019243,4344486,182128093,28,26,24,26,27,25
"1818","0000","STATE TOTAL",146985522,63291409,66568422,NA,"2020"," NJ","State Total","","State Total",6552,563,66568985,63297961,146992074,30,29,25,24,30,29
"1819","0000","STATE TOTAL",73933531389,27985506213,9455491049,NA,"2020"," NY","State Total","","State Total",8543723117,2578146332,12033637381,36529229330,82477254506,7,8,3,5,10,11
"1820","0000","STATE TOTAL",46290135347,14577364,5515738,NA,"2020"," OH","State Total","","State Total",174356364,78117338,83633076,188933728,46464491711,12,25,26,25,24,24
"1821","0000","STATE TOTAL",4162432674,486835622,298068537,NA,"2020"," OR","State Total","","State Total",671210294,208191037,506259574,1158045916,4833642968,21,18,19,17,17,18
"1822","0000","STATE TOTAL",6909699849,3734579706,652832414,NA,"2020"," PA","State Total","","State Total",16370980757,4393009776,5045842190,20105560463,23280680606,14,11,11,14,9,9
"1823","0000","STATE TOTAL",214492154,3261780,613996,NA,"2020"," RI","State Total","","State Total",745333460,145922525,146536521,748595240,959825614,27,24,28,27,22,22
"1824","0000","STATE TOTAL",30181273435,16634369425,6858462861,NA,"2020"," SC","State Total","","State Total",44261203368,8222550725,15081013586,60895572793,74442476803,8,7,7,7,5,7
"1825","0000","STATE TOTAL",1.35274e+11,28908266081,19798323790,NA,"2020"," TX","State Total","","State Total",37273640882,12609159237,32407483027,66181906963,172547600818,2,2,2,2,6,3
"1826","0000","STATE TOTAL",24531921616,21668361040,8935394614,NA,"2020"," VA","State Total","","State Total",43116044295,8998612055,17934006669,64784405335,67647965911,9,5,5,6,4,5
"1827","0000","STATE TOTAL",46535645345,11088245636,9873230055,NA,"2020"," WA","State Total","","State Total",47618457727,8322481099,18195711154,58706703363,94154103072,4,4,8,4,3,6
"1828","0000","STATE TOTAL",629995326,12629446,1122907,NA,"2020"," WI","State Total","","State Total",52613291,121490006,122612913,65242737,682608617,26,28,27,29,25,27
"1829","0000","STATE TOTAL",252985,0,0,NA,"2020"," WV","State Total","","State Total",0,0,0,0,252985,32,32,32,32,32,32
"1830","0000","STATE TOTAL",25729791749,1347756748,614394615,NA,"2021"," AK","State Total","","State Total",12232888,6871041,621265656,1359989636,25742024637,15,19,14,16,26,28
"1831","0000","STATE TOTAL",6299861112,3266467991,2142835136,NA,"2021"," AL","State Total","","State Total",8217287959,1909061288,4051896424,11483755950,14517149071,16,12,13,11,12,13
"1832","0000","STATE TOTAL",82468908364,68309646068,31531617828,NA,"2021"," CA","State Total","","State Total",3.4306e+11,65662798928,97194416756,411369654134,425528916430,1,1,1,1,1,1
"1833","0000","STATE TOTAL",486814695,517708,121110,NA,"2021"," CT","State Total","","State Total",57253243,65384248,65505358,57770951,544067938,29,27,30,28,28,26
"1834","0000","STATE TOTAL",7283907345,403854,80284,NA,"2021"," DC","State Total","","State Total",30760146,4796841,4877125,31164000,7314667491,19,30,29,30,29,30
"1835","0000","STATE TOTAL",2923513796,1171219699,359403107,NA,"2021"," DE","State Total","","State Total",1162193738,1845579283,2204982390,2333413437,4085707534,24,15,17,18,16,12
"1836","0000","STATE TOTAL",34000719219,24709325670,6406716433,NA,"2021"," FL","State Total","","State Total",37627851191,12385156750,18791873183,62337176861,71628570410,10,6,4,8,7,4
"1837","0000","STATE TOTAL",60891589680,25386376992,14340830770,NA,"2021"," GA","State Total","","State Total",92498825758,18788908683,33129739453,117885202750,153390415438,5,3,6,3,2,2
"1838","0000","STATE TOTAL",256255512,162635844,155367658,NA,"2021"," HI","State Total","","State Total",614924469,838661030,994028688,777560313,871179981,25,17,23,19,19,17
"1839","0000","STATE TOTAL",64558034712,253566503,102293833,NA,"2021"," IL","State Total","","State Total",362420293,67728186,170022019,615986796,64920455005,11,22,21,22,20,19
"1840","0000","STATE TOTAL",718654,92430,15569,NA,"2021"," IN","State Total","","State Total",0,0,15569,92430,718654,31,31,31,31,31,31
"1841","0000","STATE TOTAL",115487440811,7205916671,4498371469,NA,"2021"," LA","State Total","","State Total",6980385253,3649240581,8147612050,14186301924,122467826064,6,9,9,9,11,10
"1842","0000","STATE TOTAL",1643885095,1033154092,759616782,NA,"2021"," MA","State Total","","State Total",3311929116,828962749,1588579531,4345083208,4955814211,22,16,16,15,13,15
"1843","0000","STATE TOTAL",17124655429,7562782464,3317963276,NA,"2021"," MD","State Total","","State Total",20923821589,5809351884,9127315160,28486604053,38048477018,13,10,10,10,8,8
"1844","0000","STATE TOTAL",5024766599,698091883,74081368,NA,"2021"," ME","State Total","","State Total",936450182,234688977,308770345,1634542065,5961216781,23,23,20,23,21,20
"1845","0000","STATE TOTAL",127389248134,685257147,124250930,NA,"2021"," MI","State Total","","State Total",289131227,152683603,276934533,974388374,127678379361,3,21,18,21,23,23
"1846","0000","STATE TOTAL",5532511418,102734785,144416904,NA,"2021"," MN","State Total","","State Total",501473006,126474488,270891392,604207791,6033984424,18,20,22,20,18,21
"1847","0000","STATE TOTAL",4361762920,1421755638,1158439272,NA,"2021"," MS","State Total","","State Total",1484385572,1004064336,2162503608,2906141210,5846148492,20,14,15,13,15,16
"1848","0000","STATE TOTAL",5564173844,4365707419,1418622102,NA,"2021"," NC","State Total","","State Total",4756869050,1294680801,2713302903,9122576469,10321042894,17,13,12,12,14,14
"1849","0000","STATE TOTAL",278850747,23592060,158941,NA,"2021"," NH","State Total","","State Total",3830895,170735899,170894840,27422955,282681642,28,26,24,26,27,25
"1850","0000","STATE TOTAL",57878095,49019795,43938898,NA,"2021"," NJ","State Total","","State Total",0,0,43938898,49019795,57878095,30,29,25,24,30,29
"1851","0000","STATE TOTAL",83211379973,29819973258,9788538787,NA,"2021"," NY","State Total","","State Total",12993164031,3700362731,13488901518,42813137289,96204544004,7,8,3,5,10,11
"1852","0000","STATE TOTAL",49850919190,29453554,6632169,NA,"2021"," OH","State Total","","State Total",277798423,84483831,91116000,307251977,50128717613,12,25,26,25,24,24
"1853","0000","STATE TOTAL",5027815144,668225107,476304867,NA,"2021"," OR","State Total","","State Total",1485509531,375774166,852079033,2153734638,6513324675,21,18,19,17,17,18
"1854","0000","STATE TOTAL",9835132545,4951596889,939344576,NA,"2021"," PA","State Total","","State Total",20233509563,5373871056,6313215632,25185106452,30068642108,14,11,11,14,9,9
"1855","0000","STATE TOTAL",329365891,3011734,511235,NA,"2021"," RI","State Total","","State Total",1361930197,215228082,215739317,1364941931,1691296088,27,24,28,27,22,22
"1856","0000","STATE TOTAL",29828971720,18833408791,7245876944,NA,"2021"," SC","State Total","","State Total",55897469372,10153740853,17399617797,74730878163,85726441092,8,7,7,7,5,7
"1857","0000","STATE TOTAL",197961342193,32394529682,14518634426,NA,"2021"," TX","State Total","","State Total",51385724281,16244369263,3.0763e+10,83780253963,249347066474,2,2,2,2,6,3
"1858","0000","STATE TOTAL",30700603122,27428782275,10259594231,NA,"2021"," VA","State Total","","State Total",58573993233,11817402021,2.2077e+10,86002775508,89274596355,9,5,5,6,4,5
"1859","0000","STATE TOTAL",50850583602,11324544257,8775862391,NA,"2021"," WA","State Total","","State Total",55909467087,9593980839,18369843230,67234011344,106760050689,4,4,8,4,3,6
"1860","0000","STATE TOTAL",770998663,12723120,2609162,NA,"2021"," WI","State Total","","State Total",92715387,76383904,78993066,105438507,863714050,26,28,27,29,25,27
"1861","0000","STATE TOTAL",8375,0,0,NA,"2021"," WV","State Total","","State Total",0,0,0,0,8375,32,32,32,32,32,32
"1862","0000","COUNTY TOTAL",21625781713,14749465073,6768013627,NA,"2013"," CA","County Total","06001","Alameda",26102407882,6103391055,12871404682,40851872955,47728189595,10,5,7,7,7,6
"1863","0000","COUNTY TOTAL",770840441,3059098,226803,NA,"2013"," NY","County Total","36001","Albany",21326936,35498257,35725060,24386034,792167377,76,56,61,77,57,48
"1864","0000","COUNTY TOTAL",59017696,0,0,NA,"2013"," PA","County Total","42003","Allegheny",0,0,0,0,59017696,98,145.5,142.5,142.5,143.5,143.5
"1865","0000","COUNTY TOTAL",17397494,0,0,NA,"2013"," MI","County Total","26007","Alpena",0,0,0,0,17397494,126,135,127,130,129,125
"1866","0000","COUNTY TOTAL",18649926,1144424,344009,NA,"2013"," MD","County Total","24003","Anne Arundel",6833476,1095682,1439691,7977900,25483402,114,91,73,81,76,83
"1867","0000","COUNTY TOTAL",5111609621,1491742,577363,NA,"2013"," DC","County Total","51013","Arlington",1493693,188006,765369,2985435,5113103314,40,81,77,84,66,74
"1868","0000","COUNTY TOTAL",1295329564,0,0,NA,"2013"," ME","County Total","23003","Aroostook",0,0,0,0,1295329564,64,145.5,142.5,142.5,143.5,143.5
"1869","0000","COUNTY TOTAL",3810158534,1374858926,1411870539,NA,"2013"," AL","County Total","01003","Baldwin",3083242873,1423764531,2835635070,4458101799,6893401407,30,18,18,15,18,19
"1870","0000","COUNTY TOTAL",21021889347,4865561922,1503240969,NA,"2013"," MD","County Total","24005","Baltimore",15363653827,3664929350,5168170319,20229215749,36385543174,15,11,12,12,10,7
"1871","0000","COUNTY TOTAL",721003989,331316915,138213256,NA,"2013"," FL","County Total","12005","Bay",1095252484,179963163,318176419,1426569399,1816256473,63,47,34,43,31,45
"1872","0000","COUNTY TOTAL",1538190083,251277133,201953111,NA,"2013"," TX","County Total","48039","Brazoria",217969049,397005258,598958369,469246182,1756159132,38,23,25,19,41,34
"1873","0000","COUNTY TOTAL",144829492,544557,418396,NA,"2013"," FL","County Total","12009","Brevard",16946409,30792315,31210711,17490966,161775901,92,58,66,63,60,51
"1874","0000","COUNTY TOTAL",6664505,0,0,NA,"2013"," MA","County Total","25005","Bristol",1240544,804373,804373,1240544,7905049,124,92,98,105,77,79
"1875","0000","COUNTY TOTAL",39475268981,28461456342,7308487395,NA,"2013"," NY","County Total","36005","Bronx",8770503712,2322053104,9630540499,37231960054,48245772693,14,8,3,5,13,16
"1876","0000","COUNTY TOTAL",13408169080,8084497634,1592262888,NA,"2013"," FL","County Total","12011","Broward",7612420786,2442738970,4035001858,15696918420,21020589866,21,14,9,14,15,14
"1877","0000","COUNTY TOTAL",57232776,39235,17102,NA,"2013"," WI","County Total","55009","Brown",9239546,3400574,3417676,9278781,66472322,86,71,90,95,84,66
"1878","0000","COUNTY TOTAL",5162378689,1462716733,346109608,NA,"2013"," PA","County Total","42017","Bucks",5656605768,2216820543,2562930151,7119322501,10818984457,27,16,17,24,14,13
"1879","0000","COUNTY TOTAL",26159954,0,0,NA,"2013"," LA","County Total","22017","Caddo ",0,0,0,0,26159954,109,145.5,142.5,142.5,143.5,143.5
"1880","0000","COUNTY TOTAL",5811647553,48157727,67729025,NA,"2013"," LA","County Total","22019","Calcasieu",2622864,3226124,70955149,50780591,5814270417,35,41,48,34,47,36
"1881","0000","COUNTY TOTAL",836872581,46553149,115829262,NA,"2013"," TX","County Total","48057","Calhoun",257509306,333512719,449341981,304062455,1094381887,67,43,63,46,44,35
"1882","0000","COUNTY TOTAL",8157332005,120503414,219050222,NA,"2013"," TX","County Total","22023","Cameron",96195008,161281865,380332087,216698422,8253527013,32,36,49,28,53,43
"1883","0000","COUNTY TOTAL",371087732,563400,5101835,NA,"2013"," NC","County Total","37031","Carteret",311867276,129399246,134501081,312430676,682955008,79,54,95,79,42,47
"1884","0000","COUNTY TOTAL",9548112971,28208633,15335065,NA,"2013"," TX","County Total","48071","Chambers",3964751,1615936,16951001,32173384,9552077722,37,40,28,25,82,75
"1885","0000","COUNTY TOTAL",25903961147,13850270321,4648820081,NA,"2013"," SC","County Total","45019","Charleston",37984729802,5251308723,9900128804,5.1835e+10,63888690949,6,6,8,8,4,5
"1886","0000","COUNTY TOTAL",172384,0,0,NA,"2013"," MS","County Total","05017","Chicot",71630,11754,11754,71630,244014,152,120,122,120,114,108
"1887","0000","COUNTY TOTAL",1215669450,4135223,819583,NA,"2013"," MI","County Total","26033","Chippewa",0,0,819583,4135223,1215669450,62,73,79,96,94,68
"1888","0000","COUNTY TOTAL",162394008,0,0,NA,"2013"," WA","County Total","53009","Clallam",60320,18613,18613,60320,162454328,93,116,117,111,107,106
"1889","0000","COUNTY TOTAL",2086606009,89118016,155597955,NA,"2013"," WA","County Total","53011","Clark",37847006,27452891,183050846,126965022,2124453015,53,48,52,38,58,56
"1890","0000","COUNTY TOTAL",51248977,1171669,156802,NA,"2013"," OR","County Total","41007","Clatsop",1538096,495662,652464,2709765,52787073,105,105,101,101,86,91
"1891","0000","COUNTY TOTAL",13308066507,0,0,NA,"2013"," GA","County Total","13067","Cobb",0,0,0,0,13308066507,25,145.5,142.5,142.5,143.5,143.5
"1892","0000","COUNTY TOTAL",1504602914,43309616,50191884,NA,"2013"," CA","County Total","06013","Contra Costa",3576639,1162347,51354231,46886255,1508179553,68,59,57,49,45,62
"1893","0000","COUNTY TOTAL",170406096,2449760,38062436,NA,"2013"," OR","County Total","41011","Coos",0,0,38062436,2449760,170406096,89,79,104,69,113,81
"1894","0000","COUNTY TOTAL",6354220048,18791735,77580989,NA,"2013"," WA","County Total","53015","Cowlitz",12100945,14461303,92042292,30892680,6366320993,39,46,55,33,59,54
"1895","0000","COUNTY TOTAL",77246224,34657121,13572595,NA,"2013"," ME","County Total","23005","Cumberland",157248353,44880254,58452849,191905474,234494577,70,49,35,50,36,46
"1896","0000","COUNTY TOTAL",26237371973,10710572,2609695,NA,"2013"," OH","County Total","39035","Cuyahoga",17731526,3039205,5648900,28442098,26255103499,16,60,59,64,46,53
"1897","0000","COUNTY TOTAL",885979872,200079,75547,NA,"2013"," NJ","County Total","42045","Delaware",0,0,75547,200079,885979872,45,27,21,35,21,26
"1898","0000","COUNTY TOTAL",1941869724,1700803694,333316158,NA,"2013"," PA","County Total","42045","Delaware",3471301736,721597558,1054913716,5172105430,5413171460,45,27,21,35,21,26
"1899","0000","COUNTY TOTAL",1658044,0,0,NA,"2013"," MI","County Total","26041","Delta",129222,17438,17438,129222,1787266,140,123,126,129,109,109
"1900","0000","COUNTY TOTAL",498765244,1976155,281151,NA,"2013"," WI","County Total","55031","Douglas",14334270,19603784,19884935,16310425,513099514,77,68,84,78,56,61
"1901","0000","COUNTY TOTAL",40015838173,68480057,40155933,NA,"2013"," IL","County Total","17043","DuPage",457747906,89060211,129216144,526227963,40473586079,8,45,39,45,35,38
"1902","0000","COUNTY TOTAL",29251054074,20020861819,10831697223,NA,"2013"," GA","County Total","13103","Effingham",39454425512,8507965892,19339663115,59475287331,68705479586,4,2,6,3,2,2
"1903","0000","COUNTY TOTAL",44827244460,144670963,8047096,NA,"2013"," NY","County Total","36029","Erie",18566088,40870086,48917182,163237051,44845810548,13,63,33,52,55,63
"1904","0000","COUNTY TOTAL",45722107,0,0,NA,"2013"," OH","County Total","39043","Erie",34274,6907,6907,34274,45756381,108,109,142.5,142.5,85,92
"1905","0000","COUNTY TOTAL",861816,54845,13165,NA,"2013"," PA","County Total","42049","Erie",606658,165100,178265,661503,1468474,113,94,113,125,73,85
"1906","0000","COUNTY TOTAL",2126373,1926760,791086,NA,"2013"," MA","County Total","25009","Essex",647303,46534,837620,2574063,2773676,125,90,88,83,75,82
"1907","0000","COUNTY TOTAL",51398437,246141,105,NA,"2013"," AK","County Total","02090","Fairbanks North Star",0,0,105,246141,51398437,117,121,119,108,143.5,143.5
"1908","0000","COUNTY TOTAL",404037,260304,805158,NA,"2013"," VA","County Total","51059","Fairfax",0,0,805158,260304,404037,107,107,108,92,123,120
"1909","0000","COUNTY TOTAL",934367,21800,6589,NA,"2013"," CT","County Total","09001","Fairfield",112821,21935,28524,134621,1047188,134,126,121,116,121,117
"1910","0000","COUNTY TOTAL",32951617,0,0,NA,"2013"," OH","County Total","39045","Fairfield",0,0,0,0,32951617,81,145.5,142.5,142.5,143.5,143.5
"1911","0000","COUNTY TOTAL",33158691,0,0,NA,"2013"," NC","County Total","37067","Forsyth",0,0,0,0,33158691,103,145.5,142.5,142.5,143.5,143.5
"1912","0000","COUNTY TOTAL",2703595695,346922111,59841412,NA,"2013"," TX","County Total","48167","Galveston",647337604,285590733,345432145,994259715,3350933299,49,37,37,41,32,31
"1913","0000","COUNTY TOTAL",510088,474825,86631,NA,"2013"," SC","County Total","45043","Georgetown",508325,93593,180224,983150,1018413,133,93,97,97,81,86
"1914","0000","COUNTY TOTAL",5007920672,225042020,66505623,NA,"2013"," GA","County Total","13127","Glynn",805698567,82849535,149355158,1030740587,5813619239,36,52,32,44,30,52
"1915","0000","COUNTY TOTAL",2983868599,10900873,1290549,NA,"2013"," WA","County Total","53027","Grays Harbor",7608231,1325647,2616196,18509104,2991476830,55,67,40,57,62,70
"1916","0000","COUNTY TOTAL",4205275434,0,0,NA,"2013"," OH","County Total","39061","Hamilton",0,0,0,0,4205275434,41,145.5,142.5,142.5,143.5,143.5
"1917","0000","COUNTY TOTAL",6382386586,129330555,105715251,NA,"2013"," TX","County Total","48199","Hardin",352685522,532481385,638196636,482016077,6735072108,29,39,41,30,50,37
"1918","0000","COUNTY TOTAL",1013526694,567232249,458726674,NA,"2013"," MS","County Total","28047","Harrison",1271716288,771255307,1229981981,1838948537,2285242982,51,22,24,21,23,22
"1919","0000","COUNTY TOTAL",211799713,8250,299,NA,"2013"," CT","County Total","09003","Hartford",0,0,299,8250,211799713,83,114,112,115,87,101
"1920","0000","COUNTY TOTAL",42360196,3952978,5175926,NA,"2013"," HI","County Total","15001","Hawaii",773166,206723,5382649,4726144,43133362,88,77,64,60,95,95
"1921","0000","COUNTY TOTAL",2120168975,0,0,NA,"2013"," MN","County Total","27054","Hennepin",0,0,0,0,2120168975,61,145.5,142.5,142.5,143.5,143.5
"1922","0000","COUNTY TOTAL",2554480526,88347304,67048963,NA,"2013"," FL","County Total","12057","Hillsborough",492413330,280211580,347260543,580760634,3046893856,50,32,44,39,25,27
"1923","0000","COUNTY TOTAL",272303436,93955349,167722049,NA,"2013"," HI","County Total","15003","Honolulu",477277166,156524859,324246908,571232515,749580602,69,25,43,37,34,24
"1924","0000","COUNTY TOTAL",251954905,252153,138333,NA,"2013"," AK","County Total","02105","Hoonah-Angoon",344711,3902,142235,596864,252299616,84,103,82,89,108,119
"1925","0000","COUNTY TOTAL",22686198,0,0,NA,"2013"," CA","County Total","06023","Humboldt",338937,63972,63972,338937,23025135,116,82,103,66,89,97
"1926","0000","COUNTY TOTAL",4784940876,50071149,90970371,NA,"2013"," MS","County Total","28059","Jackson",275308,96097,91066468,50346457,4785216184,48,42,31,26,69,84
"1927","0000","COUNTY TOTAL",11717905,0,0,NA,"2013"," AL","County Total","01073","Jefferson",0,0,0,0,11717905,100,145.5,142.5,142.5,143.5,143.5
"1928","0000","COUNTY TOTAL",6737787297,5364138,315746,NA,"2013"," NY","County Total","36045","Jefferson",19756430,37796,353542,25120568,6757543727,34,96,69,82,78,99
"1929","0000","COUNTY TOTAL",553762985,550206952,889915,NA,"2013"," WA","County Total","53031","Jefferson",573352,6538,896453,550780304,554336337,87,101,38,88,98,111
"1930","0000","COUNTY TOTAL",4271755,0,0,NA,"2013"," MI","County Total","26081","Kent",0,0,0,0,4271755,128,145.5,142.5,142.5,143.5,143.5
"1931","0000","COUNTY TOTAL",62571722,917246,439046,NA,"2013"," AK","County Total","02130","Ketchikan Gateway",0,0,439046,917246,62571722,99,99,89,90,97,90
"1932","0000","COUNTY TOTAL",7695371982,4936843721,4457367473,NA,"2013"," WA","County Total","53035","Kitsap",20242168387,4186254387,8643621860,25179012108,27937540369,17,10,14,10,11,11
"1933","0000","COUNTY TOTAL",6190908145,252128860,216161091,NA,"2013"," MN","County Total","27071","Koochiching",524616370,126944232,343105323,776745230,6715524515,44,44,42,36,33,42
"1934","0000","COUNTY TOTAL",15839624,10583345,3685580,NA,"2013"," OR","County Total","41041","Lincoln",0,0,3685580,10583345,15839624,135,100,83,87,128,128
"1935","0000","COUNTY TOTAL",40783015641,31315611020,12579231205,NA,"2013"," CA","County Total","06037","Los Angeles",216366137735,34226275184,46805506389,247681748755,257149153376,1,1,1,1,1,1
"1936","0000","COUNTY TOTAL",88016,0,0,NA,"2013"," MS","County Total","22065","Madison",11086,420,420,11086,99102,148,124,142.5,142.5,120,113
"1937","0000","COUNTY TOTAL",232719135,5251905,3478864,NA,"2013"," FL","County Total","12081","Manatee",133905701,266441854,269920718,139157606,366624836,80,35,60,47,38,28
"1938","0000","COUNTY TOTAL",4902120,108068,7394,NA,"2013"," WI","County Total","55075","Marinette",11419,2049,9443,119487,4913539,144,130,107,119,132,131
"1939","0000","COUNTY TOTAL",313952278,0,0,NA,"2013"," MI","County Total","26103","Marquette",627,376,376,627,313952905,96,125,142.5,142.5,106,114
"1940","0000","COUNTY TOTAL",14708691643,100063333,42821683,NA,"2013"," AK","County Total","02170","Matanuska-Susitna",35292958,36072583,78894266,135356291,14743984601,23,33,20,22,61,57
"1941","0000","COUNTY TOTAL",57550750,4349512,2661882,NA,"2013"," HI","County Total","15009","Maui",116894,14112,2675994,4466406,57667644,121,89,76,75,105,105
"1942","0000","COUNTY TOTAL",11284989874,7229745207,1837453698,NA,"2013"," FL","County Total","12086","Miami-Dade",12028278354,2511020638,4348474336,19258023561,23313268228,18,13,10,13,12,12
"1943","0000","COUNTY TOTAL",23073380,1781432,420060,NA,"2013"," FL","County Total","12087","Monroe",83596,23552,443612,1865028,23156976,106,95,78,80,100,103
"1944","0000","COUNTY TOTAL",5186589,138257,28427,NA,"2013"," NY","County Total","36055","Monroe",777323,41623,70050,915580,5963912,123,108,100,100,96,100
"1945","0000","COUNTY TOTAL",586663,491562,128811,NA,"2013"," CA","County Total","06053","Monterey",151825,15411,144222,643387,738488,131,88,80,74,111,116
"1946","0000","COUNTY TOTAL",12672801,0,0,NA,"2013"," OH","County Total","39113","Montgomery",0,0,0,0,12672801,112,145.5,142.5,142.5,143.5,143.5
"1947","0000","COUNTY TOTAL",94171591689,29061612946,12518625201,NA,"2013"," TX","County Total","48339","Montgomery",24524136632,8313745183,20832370384,53585749578,118695728321,2,3,2,2,6,3
"1948","0000","COUNTY TOTAL",3143206361,166842,25440,NA,"2013"," AL","County Total","01103","Morgan",0,0,25440,166842,3143206361,56,106,91,91,143.5,143.5
"1949","0000","COUNTY TOTAL",471910,447220,43694,NA,"2013"," MI","County Total","26121","Muskegon",0,0,43694,447220,471910,146,112,99,107,104,102
"1950","0000","COUNTY TOTAL",12541638452,3945537821,1111483519,NA,"2013"," FL","County Total","12089","Nassau",4056715407,1195087467,2306570986,8002253228,16598353859,28,17,16,17,16,17
"1951","0000","COUNTY TOTAL",3812843375,2226343950,989223455,NA,"2013"," NC","County Total","37129","New Hanover",3944024312,1097364024,2086587479,6170368262,7756867687,31,19,15,16,20,21
"1952","0000","COUNTY TOTAL",148856757,0,0,NA,"2013"," CT","County Total","09009","New Haven",29837,9100,9100,29837,148886594,97,62,85,70,67,55
"1953","0000","COUNTY TOTAL",2429548,0,0,NA,"2013"," CT","County Total","09011","New London",484963,613433,613433,484963,2914511,118,83,102,104,80,73
"1954","0000","COUNTY TOTAL",673772,595100,150803,NA,"2013"," MA","County Total","44005","Newport",385673,102738,253541,980773,1059445,115,104,92,103,93,89
"1955","0000","COUNTY TOTAL",31533196,287633,62159,NA,"2013"," RI","County Total","44005","Newport",69789,31526,93685,357422,31602985,115,104,92,103,93,89
"1956","0000","COUNTY TOTAL",1234937162,705342842,465363327,NA,"2013"," MA","County Total","25021","Norfolk",3629821406,833446259,1298809586,4335164248,4864758568,42,21,22,20,19,20
"1957","0000","COUNTY TOTAL",81546251780,714187891,140828212,NA,"2013"," MI","County Total","26125","Oakland",239778546,127865557,268693769,953966437,81786030326,5,55,36,48,48,49
"1958","0000","COUNTY TOTAL",149907372,0,0,NA,"2013"," NY","County Total","36067","Onondaga",0,0,0,0,149907372,101,145.5,142.5,142.5,143.5,143.5
"1959","0000","COUNTY TOTAL",3.9628e+10,29427466453,12719575846,NA,"2013"," CA","County Total","06059","Orange",62234797660,9258136600,21977712446,91662264113,101862795828,3,4,4,4,3,4
"1960","0000","COUNTY TOTAL",2937729,0,0,NA,"2013"," TX","County Total","48361","Orange",0,0,0,0,2937729,110,98,74,85,118,122
"1961","0000","COUNTY TOTAL",62917958466,4652157060,2443395565,NA,"2013"," LA","County Total","22071","Orleans",5592405671,2766193859,5209589424,10244562731,68510364137,7,12,13,11,17,15
"1962","0000","COUNTY TOTAL",1060133609,0,0,NA,"2013"," FL","County Total","12097","Osceola",0,0,0,0,1060133609,60,145.5,142.5,142.5,143.5,143.5
"1963","0000","COUNTY TOTAL",1764539,0,0,NA,"2013"," NY","County Total","36075","Oswego",37036552,80418908,80418908,37036552,38801091,119,70,106,124,70,65
"1964","0000","COUNTY TOTAL",1861080016,1266048266,464190164,NA,"2013"," FL","County Total","12099","Palm Beach",303436122,127463071,591653235,1569484388,2164516138,54,29,19,23,39,41
"1965","0000","COUNTY TOTAL",664908051,313305,68307,NA,"2013"," ME","County Total","23019","Penobscot",0,0,68307,313305,664908051,65,84,93,99,88,76
"1966","0000","COUNTY TOTAL",5918130,0,0,NA,"2013"," IL","County Total","17143","Peoria",106918,21660,21660,106918,6025048,129,110,130,114,79,96
"1967","0000","COUNTY TOTAL",214838141,37651525,541016,NA,"2013"," NJ","County Total","42101","Philadelphia",3602382,2352251,2893267,41253907,218440523,94,76,56,76,74,71
"1968","0000","COUNTY TOTAL",11151597279,7551097971,4926214468,NA,"2013"," WA","County Total","53053","Pierce",32791625070,4444336557,9370551025,40342723041,43943222349,12,9,11,9,5,8
"1969","0000","COUNTY TOTAL",71119,0,0,NA,"2013"," MA","County Total","25023","Plymouth",33537,3600,3600,33537,104656,147,102,109,94,103,93
"1970","0000","COUNTY TOTAL",468398,0,0,NA,"2013"," IN","County Total","18127","Porter",0,0,0,0,468398,136,119,114,118,116,110
"1971","0000","COUNTY TOTAL",1929199,0,0,NA,"2013"," MI","County Total","26141","Presque Isle",0,0,0,0,1929199,143,133,128,126,143.5,143.5
"1972","0000","COUNTY TOTAL",299175646,533584,50999,NA,"2013"," RI","County Total","44007","Providence",584237854,28171401,28222400,584771438,883413500,73,51,70,62,37,44
"1973","0000","COUNTY TOTAL",5686555,174821,9453,NA,"2013"," WI","County Total","55101","Racine",57127,20235,29688,231948,5743682,141,113,94,110,115,104
"1974","0000","COUNTY TOTAL",347334,0,0,NA,"2013"," SC","County Total","45079","Richland",0,0,0,0,347334,142,145.5,142.5,142.5,143.5,143.5
"1975","0000","COUNTY TOTAL",584179813,64975518,45998849,NA,"2013"," NH","County Total","33015","Rockingham",37753553,9526255,55525104,102729071,621933366,75,57,54,58,63,50
"1976","0000","COUNTY TOTAL",18000,18000,20000,NA,"2013"," MI","County Total","26145","Saginaw",447869,34491,54491,465869,465869,130,78,129,128,91,72
"1977","0000","COUNTY TOTAL",3003071377,302688665,188385837,NA,"2013"," DE","County Total","34033","Salem",700883327,1170926397,1359312234,1003571992,3703954704,46,20,23,29,26,18
"1978","0000","COUNTY TOTAL",895713708,62538160,9391907,NA,"2013"," CA","County Total","06073","San Diego",952897340,513014903,522406810,1015435500,1848611048,58,28,45,54,28,23
"1979","0000","COUNTY TOTAL",354862184,26100,120757,NA,"2013"," CA","County Total","06077","San Joaquin",131243577,291646303,291767060,131269677,486105761,78,50,71,67,54,40
"1980","0000","COUNTY TOTAL",420992,0,0,NA,"2013"," WA","County Total","53055","San Juan",860289,42562,42562,860289,1281281,127,127,124,121,117,115
"1981","0000","COUNTY TOTAL",459036,97744,18755,NA,"2013"," CA","County Total","06079","San Luis Obispo",114881,24093,42848,212625,573917,138,118,116,113,110,112
"1982","0000","COUNTY TOTAL",1662204641,40901193,40036641,NA,"2013"," CA","County Total","06081","San Mateo",661339023,208492630,248529271,702240216,2323543664,47,38,46,55,22,30
"1983","0000","COUNTY TOTAL",10437823605,799385585,1387906207,NA,"2013"," TX","County Total","48409","San Patricio",377944088,108478366,1496384573,1177329673,10815767693,20,24,27,18,40,39
"1984","0000","COUNTY TOTAL",219922496,186510,207184,NA,"2013"," FL","County Total","12113","Santa Rosa",2048080,658074,865258,2234590,221970576,90,80,75,72,71,78
"1985","0000","COUNTY TOTAL",2235356802,420720,148771,NA,"2013"," WA","County Total","53057","Skagit",80025,825753,974524,500745,2235436827,66,74,68,61,90,88
"1986","0000","COUNTY TOTAL",138899451,0,0,NA,"2013"," AK","County Total","02230","Skagway",0,0,0,0,138899451,85,129,123,117,124,123
"1987","0000","COUNTY TOTAL",22374734040,272009770,15355566,NA,"2013"," WA","County Total","53061","Snohomish",1321829574,5167302,20522868,1593839344,23696563614,22,61,51,53,24,60
"1988","0000","COUNTY TOTAL",45536416378,412487149,62783348,NA,"2013"," MI","County Total","26147","St. Clair",84657137,11812722,74596070,497144286,45621073515,11,53,26,42,49,58
"1989","0000","COUNTY TOTAL",14942303882,35692472,25954810,NA,"2013"," LA","County Total","22093","St. James",181771956,415472430,441427240,217464428,15124075838,26,34,50,32,52,32
"1990","0000","COUNTY TOTAL",576277719,129085,40129,NA,"2013"," NY","County Total","36089","St. Lawrence",1781247,1432478,1472607,1910332,578058966,71,97,110,106,83,87
"1991","0000","COUNTY TOTAL",44337353,5340759,888067,NA,"2013"," FL","County Total","12111","St. Lucie",109234,1817160,2705227,5449993,44446587,111,86,87,93,102,77
"1992","0000","COUNTY TOTAL",2184406787,4124998,1389944,NA,"2013"," LA","County Total","22101","St. Mary",92494956,7670836,9060780,96619954,2276901743,52,65,58,59,51,64
"1993","0000","COUNTY TOTAL",126146893,460028,1072859,NA,"2013"," WA","County Total","53067","Thurston",0,0,1072859,460028,126146893,95,85,86,71,112,118
"1994","0000","COUNTY TOTAL",827552448,88223803,37768178,NA,"2013"," CA","County Total","06111","Ventura",345472179,194173784,231941962,433695982,1173024627,57,30,30,40,27,25
"1995","0000","COUNTY TOTAL",29714654686,19992031716,6894729729,NA,"2013"," VA","County Total","51811","Virginia Beach",34884957265,7060091465,13954821194,54876988981,64599611951,9,7,5,6,8.5,9.5
"1996","0000","COUNTY TOTAL",29714654686,19992031716,6894729729,NA,"2013"," VA","County Total","51811","Virginia Beach",30959605,31337135,6926066864,20022991321,29745614291,9,7,5,6,8.5,9.5
"1997","0000","COUNTY TOTAL",8924552,3020221,612318,NA,"2013"," VA","County Total","51812","Virginia Beach",34884957265,7060091465,7060703783,34887977486,34893881817,19,15,72,65,8.5,9.5
"1998","0000","COUNTY TOTAL",8924552,3020221,612318,NA,"2013"," VA","County Total","51812","Virginia Beach",30959605,31337135,31949453,33979826,39884157,19,15,72,65,8.5,9.5
"1999","0000","COUNTY TOTAL",138874,0,0,NA,"2013"," WV","County Total","51813","Virginia Beach",0,0,0,0,138874,151,145.5,142.5,142.5,143.5,143.5
"2000","0000","COUNTY TOTAL",639352491,0,0,NA,"2013"," NC","County Total","37183","Wake",0,0,0,0,639352491,82,145.5,142.5,142.5,143.5,143.5
"2001","0000","COUNTY TOTAL",370057,0,0,NA,"2013"," ME","County Total","23027","Waldo",4028429,490318,490318,4028429,4398486,104,72,105,98,65,67
"2002","0000","COUNTY TOTAL",2009766506,51644032,74123748,NA,"2013"," ME","County Total","23029","Washington",67827,78600,74202348,51711859,2009834333,59,66,62,51,101,98
"2003","0000","COUNTY TOTAL",4423066195,782803698,716088928,NA,"2013"," OR","County Total","41067","Washington",2154389673,1131273923,1847362851,2937193371,6577455868,43,26,29,27,29,33
"2004","0000","COUNTY TOTAL",65802008,259302,46881,NA,"2013"," WI","County Total","55133","Waukesha",18355137,988384,1035265,18614439,84157145,91,75,65,86,72,69
"2005","0000","COUNTY TOTAL",7925031,0,0,NA,"2013"," NY","County Total","36117","Wayne",0,0,0,0,7925031,137,131,142.5,142.5,122,121
"2006","0000","COUNTY TOTAL",5046990529,12136819,27584620,NA,"2013"," LA","County Total","22121","West Baton Rouge",314232576,699071362,726655982,326369395,5361223105,33,31,53,31,43,29
"2007","0000","COUNTY TOTAL",19767558165,69904261,17355811,NA,"2013"," WA","County Total","53073","Whatcom",22305410,1258082,18613893,92209671,19789863575,24,69,47,56,68,80
"2008","0000","COUNTY TOTAL",718546860,345030,185188,NA,"2013"," OH","County Total","39173","Wood",23967898,46755608,46940796,24312928,742514758,74,64,81,68,64,59
"2009","0000","COUNTY TOTAL",1464154,0,0,NA,"2013"," MA","County Total","25027","Worcester",0,0,0,0,1464154,102,115,96,102,143.5,143.5
"2010","0000","COUNTY TOTAL",10162004,9601483,5115078,NA,"2013"," AK","County Total","02275","Wrangell",0,0,5115078,9601483,10162004,132,87,67,73,125,130
"2011","0000","COUNTY TOTAL",564303732,0,0,NA,"2013"," NC","County Total","45091","York",0,0,0,0,564303732,72,145.5,142.5,142.5,143.5,143.5
"2012","0000","COUNTY TOTAL",23416925537,15877655773,6718234098,NA,"2014"," CA","County Total","06001","Alameda",27621403591,6537489244,13255723342,43499059364,51038329128,10,5,7,7,7,6
"2013","0000","COUNTY TOTAL",1295278395,6593754,7553043,NA,"2014"," NY","County Total","36001","Albany",14672895,119574461,127127504,21266649,1309951290,76,56,61,77,57,48
"2014","0000","COUNTY TOTAL",61374363,0,0,NA,"2014"," PA","County Total","42003","Allegheny",0,0,0,0,61374363,98,145.5,142.5,142.5,143.5,143.5
"2015","0000","COUNTY TOTAL",12942558,0,0,NA,"2014"," MI","County Total","26007","Alpena",0,0,0,0,12942558,126,135,127,130,129,125
"2016","0000","COUNTY TOTAL",14042488,3855074,914039,NA,"2014"," MD","County Total","24003","Anne Arundel",10999898,1043350,1957389,14854972,25042386,114,91,73,81,76,83
"2017","0000","COUNTY TOTAL",5417981236,5339382,2363159,NA,"2014"," DC","County Total","51013","Arlington",2735768,2693306,5056465,8075150,5420717004,40,81,77,84,66,74
"2018","0000","COUNTY TOTAL",1170093699,0,0,NA,"2014"," ME","County Total","23003","Aroostook",0,0,0,0,1170093699,64,145.5,142.5,142.5,143.5,143.5
"2019","0000","COUNTY TOTAL",3736180049,1486118420,1499133226,NA,"2014"," AL","County Total","01003","Baldwin",2837626583,998538874,2497672100,4323745003,6573806632,30,18,18,15,18,19
"2020","0000","COUNTY TOTAL",18624613894,4771435564,1440932090,NA,"2014"," MD","County Total","24005","Baltimore",16264787393,4015688113,5456620203,21036222957,34889401287,15,11,12,12,10,7
"2021","0000","COUNTY TOTAL",830904102,291419434,113854479,NA,"2014"," FL","County Total","12005","Bay",710912442,125133734,238988213,1002331876,1541816544,63,47,34,43,31,45
"2022","0000","COUNTY TOTAL",2695103252,431466521,444382601,NA,"2014"," TX","County Total","48039","Brazoria",202558528,361217273,805599874,634025049,2897661780,38,23,25,19,41,34
"2023","0000","COUNTY TOTAL",52546405,611405,256194,NA,"2014"," FL","County Total","12009","Brevard",2606061,6447013,6703207,3217466,55152466,92,58,66,63,60,51
"2024","0000","COUNTY TOTAL",268926,117436,17730,NA,"2014"," MA","County Total","25005","Bristol",1500865,923347,941077,1618301,1769791,124,92,98,105,77,79
"2025","0000","COUNTY TOTAL",39681435621,28521943095,7035876158,NA,"2014"," NY","County Total","36005","Bronx",9827044248,2609450564,9645326722,38348987343,49508479869,14,8,3,5,13,16
"2026","0000","COUNTY TOTAL",13626978551,8609097122,1661907655,NA,"2014"," FL","County Total","12011","Broward",9208428276,2851737041,4513644696,17817525398,22835406827,21,14,9,14,15,14
"2027","0000","COUNTY TOTAL",80657104,0,0,NA,"2014"," WI","County Total","55009","Brown",249685,1722,1722,249685,80906789,86,71,90,95,84,66
"2028","0000","COUNTY TOTAL",5310650425,1765606520,476514549,NA,"2014"," PA","County Total","42017","Bucks",7612584326,2581445918,3057960467,9378190846,12923234751,27,16,17,24,14,13
"2029","0000","COUNTY TOTAL",13947210,0,0,NA,"2014"," LA","County Total","22017","Caddo ",0,0,0,0,13947210,109,145.5,142.5,142.5,143.5,143.5
"2030","0000","COUNTY TOTAL",5456585377,36263379,43139193,NA,"2014"," LA","County Total","22019","Calcasieu",28252871,15885299,59024492,64516250,5484838248,35,41,48,34,47,36
"2031","0000","COUNTY TOTAL",819995620,19505158,93173554,NA,"2014"," TX","County Total","48057","Calhoun",216580544,285368099,378541653,236085702,1036576164,67,43,63,46,44,35
"2032","0000","COUNTY TOTAL",9384123876,62525190,189977391,NA,"2014"," TX","County Total","22023","Cameron",201782624,291040733,481018124,264307814,9585906500,32,36,49,28,53,43
"2033","0000","COUNTY TOTAL",231265881,439557,2108800,NA,"2014"," NC","County Total","37031","Carteret",235874216,137242223,139351023,236313773,467140097,79,54,95,79,42,47
"2034","0000","COUNTY TOTAL",8803583430,426420728,301050546,NA,"2014"," TX","County Total","48071","Chambers",7550957,15642368,316692914,433971685,8811134387,37,40,28,25,82,75
"2035","0000","COUNTY TOTAL",30429905807,14594309681,5064092926,NA,"2014"," SC","County Total","45019","Charleston",41918410664,6177163013,11241255939,56512720345,72348316471,6,6,8,8,4,5
"2036","0000","COUNTY TOTAL",17515,0,0,NA,"2014"," MS","County Total","05017","Chicot",9469,3188,3188,9469,26984,152,120,122,120,114,108
"2037","0000","COUNTY TOTAL",1145423828,84960,19198,NA,"2014"," MI","County Total","26033","Chippewa",7345274,7097000,7116198,7430234,1152769102,62,73,79,96,94,68
"2038","0000","COUNTY TOTAL",109911099,109343,195710,NA,"2014"," WA","County Total","53009","Clallam",39494,2417,198127,148837,109950593,93,116,117,111,107,106
"2039","0000","COUNTY TOTAL",2242657933,49969168,72993573,NA,"2014"," WA","County Total","53011","Clark",97834628,35462661,108456234,147803796,2340492561,53,48,52,38,58,56
"2040","0000","COUNTY TOTAL",53490272,173506,115329,NA,"2014"," OR","County Total","41007","Clatsop",3042768,183021,298350,3216274,56533040,105,105,101,101,86,91
"2041","0000","COUNTY TOTAL",14028323779,0,0,NA,"2014"," GA","County Total","13067","Cobb",0,0,0,0,14028323779,25,145.5,142.5,142.5,143.5,143.5
"2042","0000","COUNTY TOTAL",1407193954,70182592,116883863,NA,"2014"," CA","County Total","06013","Contra Costa",4873139,10159135,127042998,75055731,1412067093,68,59,57,49,45,62
"2043","0000","COUNTY TOTAL",139974390,0,0,NA,"2014"," OR","County Total","41011","Coos",0,0,0,0,139974390,89,79,104,69,113,81
"2044","0000","COUNTY TOTAL",6321040606,16636115,74354411,NA,"2014"," WA","County Total","53015","Cowlitz",14084133,733631,75088042,30720248,6335124739,39,46,55,33,59,54
"2045","0000","COUNTY TOTAL",228395078,57783959,20624038,NA,"2014"," ME","County Total","23005","Cumberland",242010224,75513911,96137949,299794183,470405302,70,49,35,50,36,46
"2046","0000","COUNTY TOTAL",26212375134,68775107,9194280,NA,"2014"," OH","County Total","39035","Cuyahoga",42198656,60415804,69610084,110973763,26254573790,16,60,59,64,46,53
"2047","0000","COUNTY TOTAL",620798735,120961,28542,NA,"2014"," NJ","County Total","42045","Delaware",103765,64406,92948,224726,620902500,45,27,21,35,21,26
"2048","0000","COUNTY TOTAL",2049420075,1811924950,338351920,NA,"2014"," PA","County Total","42045","Delaware",3320990420,669207976,1007559896,5132915370,5370410495,45,27,21,35,21,26
"2049","0000","COUNTY TOTAL",1559711,0,0,NA,"2014"," MI","County Total","26041","Delta",141022,20388,20388,141022,1700733,140,123,126,129,109,109
"2050","0000","COUNTY TOTAL",5000,0,0,NA,"2014"," MD","County Total","24019","Dorchester",4759577,253057,253057,4759577,4764577,120,111,120,122,92,94
"2051","0000","COUNTY TOTAL",450741845,0,0,NA,"2014"," WI","County Total","55031","Douglas",44719662,3216833,3216833,44719662,495461507,77,68,84,78,56,61
"2052","0000","COUNTY TOTAL",44078446314,104290956,36225563,NA,"2014"," IL","County Total","17043","DuPage",610247281,240889723,277115286,714538237,44688693595,8,45,39,45,35,38
"2053","0000","COUNTY TOTAL",29672905679,20447036501,11306354500,NA,"2014"," GA","County Total","13103","Effingham",48344594669,9921873735,21228228235,68791631170,78017500348,4,2,6,3,2,2
"2054","0000","COUNTY TOTAL",49398789039,142482709,16493404,NA,"2014"," NY","County Total","36029","Erie",59168730,23759598,40253002,201651439,49457957769,13,63,33,52,55,63
"2055","0000","COUNTY TOTAL",7732245,0,0,NA,"2014"," OH","County Total","39043","Erie",35879,19600,19600,35879,7768124,108,109,142.5,142.5,85,92
"2056","0000","COUNTY TOTAL",54453025,480397,26412,NA,"2014"," PA","County Total","42049","Erie",8644752,1158501,1184913,9125149,63097777,113,94,113,125,73,85
"2057","0000","COUNTY TOTAL",1325717,750393,491150,NA,"2014"," MA","County Total","25009","Essex",3817161,3562862,4054012,4567554,5142878,125,90,88,83,75,82
"2058","0000","COUNTY TOTAL",56469934,0,0,NA,"2014"," AK","County Total","02090","Fairbanks North Star",0,0,0,0,56469934,117,121,119,108,143.5,143.5
"2059","0000","COUNTY TOTAL",78904687,242074,828899,NA,"2014"," VA","County Total","51059","Fairfax",181515,10836,839735,423589,79086202,107,107,108,92,123,120
"2060","0000","COUNTY TOTAL",3666268,25121,32770,NA,"2014"," CT","County Total","09001","Fairfield",0,0,32770,25121,3666268,134,126,121,116,121,117
"2061","0000","COUNTY TOTAL",239336098,0,0,NA,"2014"," OH","County Total","39045","Fairfield",0,0,0,0,239336098,81,145.5,142.5,142.5,143.5,143.5
"2062","0000","COUNTY TOTAL",21019489,0,0,NA,"2014"," NC","County Total","37067","Forsyth",0,0,0,0,21019489,103,145.5,142.5,142.5,143.5,143.5
"2063","0000","COUNTY TOTAL",3984283431,243073159,54453147,NA,"2014"," TX","County Total","48167","Galveston",821184117,417918778,472371925,1064257276,4805467548,49,37,37,41,32,31
"2064","0000","COUNTY TOTAL",445588,329676,326957,NA,"2014"," SC","County Total","45043","Georgetown",791458,79922,406879,1121134,1237046,133,93,97,97,81,86
"2065","0000","COUNTY TOTAL",5521895890,268925431,152574875,NA,"2014"," GA","County Total","13127","Glynn",382911618,26910396,179485271,651837049,5904807508,36,52,32,44,30,52
"2066","0000","COUNTY TOTAL",3573834249,2800948,432628,NA,"2014"," WA","County Total","53027","Grays Harbor",21354572,37105488,37538116,24155520,3595188821,55,67,40,57,62,70
"2067","0000","COUNTY TOTAL",4382457294,0,0,NA,"2014"," OH","County Total","39061","Hamilton",0,0,0,0,4382457294,41,145.5,142.5,142.5,143.5,143.5
"2068","0000","COUNTY TOTAL",6510040132,95315764,92496696,NA,"2014"," TX","County Total","48199","Hardin",228959318,320597688,413094384,324275082,6738999450,29,39,41,30,50,37
"2069","0000","COUNTY TOTAL",918176570,551103127,412567758,NA,"2014"," MS","County Total","28047","Harrison",1278096672,1035651094,1448218852,1829199799,2196273242,51,22,24,21,23,22
"2070","0000","COUNTY TOTAL",403331123,13688,3138,NA,"2014"," CT","County Total","09003","Hartford",65628,29988,33126,79316,403396751,83,114,112,115,87,101
"2071","0000","COUNTY TOTAL",117742347,4019742,2158094,NA,"2014"," HI","County Total","15001","Hawaii",963656,147478,2305572,4983398,118706003,88,77,64,60,95,95
"2072","0000","COUNTY TOTAL",2053496200,0,0,NA,"2014"," MN","County Total","27054","Hennepin",0,0,0,0,2053496200,61,145.5,142.5,142.5,143.5,143.5
"2073","0000","COUNTY TOTAL",2570609357,77042306,86441121,NA,"2014"," FL","County Total","12057","Hillsborough",537315106,321793067,408234188,614357412,3107924463,50,32,44,39,25,27
"2074","0000","COUNTY TOTAL",776325193,127346776,160763128,NA,"2014"," HI","County Total","15003","Honolulu",476379351,154529380,315292508,603726127,1252704544,69,25,43,37,34,24
"2075","0000","COUNTY TOTAL",203270608,0,0,NA,"2014"," AK","County Total","02105","Hoonah-Angoon",171726,38751,38751,171726,203442334,84,103,82,89,108,119
"2076","0000","COUNTY TOTAL",19402873,0,0,NA,"2014"," CA","County Total","06023","Humboldt",1317957,140205,140205,1317957,20720830,116,82,103,66,89,97
"2077","0000","COUNTY TOTAL",4192532297,89781163,119162037,NA,"2014"," MS","County Total","28059","Jackson",2347009,130238,119292275,92128172,4194879306,48,42,31,26,69,84
"2078","0000","COUNTY TOTAL",515125,0,0,NA,"2014"," AL","County Total","01073","Jefferson",0,0,0,0,515125,100,145.5,142.5,142.5,143.5,143.5
"2079","0000","COUNTY TOTAL",6720264677,1136930,133260,NA,"2014"," NY","County Total","36045","Jefferson",2045041,14603,147863,3181971,6722309718,34,96,69,82,78,99
"2080","0000","COUNTY TOTAL",132220735,129698732,558056,NA,"2014"," WA","County Total","53031","Jefferson",922440,67804,625860,130621172,133143175,87,101,38,88,98,111
"2081","0000","COUNTY TOTAL",10397482,0,0,NA,"2014"," MI","County Total","26081","Kent",0,0,0,0,10397482,128,145.5,142.5,142.5,143.5,143.5
"2082","0000","COUNTY TOTAL",51934195,311812,148754,NA,"2014"," AK","County Total","02130","Ketchikan Gateway",0,0,148754,311812,51934195,99,99,89,90,97,90
"2083","0000","COUNTY TOTAL",7947129473,4454329654,3968948670,NA,"2014"," WA","County Total","53035","Kitsap",13496299233,3493072869,7462021539,17950628887,21443428706,17,10,14,10,11,11
"2084","0000","COUNTY TOTAL",5316556538,146980899,141908591,NA,"2014"," MN","County Total","27071","Koochiching",676626104,141175335,283083926,823607003,5993182642,44,44,42,36,33,42
"2085","0000","COUNTY TOTAL",10979095,0,0,NA,"2014"," OR","County Total","41041","Lincoln",4413,1724,1724,4413,10983508,135,100,83,87,128,128
"2086","0000","COUNTY TOTAL",39953672208,32292459930,13445655925,NA,"2014"," CA","County Total","06037","Los Angeles",222370305176,36467118919,49912774844,254662765106,2.62324e+11,1,1,1,1,1,1
"2087","0000","COUNTY TOTAL",140079,0,0,NA,"2014"," MS","County Total","22065","Madison",8908,132,132,8908,148987,148,124,142.5,142.5,120,113
"2088","0000","COUNTY TOTAL",102862576,6114352,3286029,NA,"2014"," FL","County Total","12081","Manatee",162549833,311952196,315238225,168664185,265412409,80,35,60,47,38,28
"2089","0000","COUNTY TOTAL",3099325,0,0,NA,"2014"," WI","County Total","55075","Marinette",0,0,0,0,3099325,144,130,107,119,132,131
"2090","0000","COUNTY TOTAL",169866893,0,0,NA,"2014"," MI","County Total","26103","Marquette",1140323,98175,98175,1140323,171007216,96,125,142.5,142.5,106,114
"2091","0000","COUNTY TOTAL",17186215403,1901133307,738246653,NA,"2014"," AK","County Total","02170","Matanuska-Susitna",38417075,42068107,780314760,1939550382,17224632478,23,33,20,22,61,57
"2092","0000","COUNTY TOTAL",8861281,6976907,1809111,NA,"2014"," HI","County Total","15009","Maui",2018026,138643,1947754,8994933,10879307,121,89,76,75,105,105
"2093","0000","COUNTY TOTAL",10674513186,7176271902,1804547305,NA,"2014"," FL","County Total","12086","Miami-Dade",12026245655,2659547951,4464095256,19202517557,22700758841,18,13,10,13,12,12
"2094","0000","COUNTY TOTAL",33614879,8584604,2386382,NA,"2014"," FL","County Total","12087","Monroe",305749,47646,2434028,8890353,33920628,106,95,78,80,100,103
"2095","0000","COUNTY TOTAL",16796756,383382,23141,NA,"2014"," NY","County Total","36055","Monroe",454660,55459,78600,838042,17251416,123,108,100,100,96,100
"2096","0000","COUNTY TOTAL",7792389,7695841,294676,NA,"2014"," CA","County Total","06053","Monterey",0,0,294676,7695841,7792389,131,88,80,74,111,116
"2097","0000","COUNTY TOTAL",33987615,0,0,NA,"2014"," OH","County Total","39113","Montgomery",0,0,0,0,33987615,112,145.5,142.5,142.5,143.5,143.5
"2098","0000","COUNTY TOTAL",92033059014,29007520145,10222793199,NA,"2014"," TX","County Total","48339","Montgomery",27344442292,8778298138,19001091337,56351962437,119377501306,2,3,2,2,6,3
"2099","0000","COUNTY TOTAL",3176876217,0,0,NA,"2014"," AL","County Total","01103","Morgan",0,0,0,0,3176876217,56,106,91,91,143.5,143.5
"2100","0000","COUNTY TOTAL",223463,212812,18500,NA,"2014"," MI","County Total","26121","Muskegon",168192,18212,36712,381004,391655,146,112,99,107,104,102
"2101","0000","COUNTY TOTAL",11003201089,4167334121,1088888097,NA,"2014"," FL","County Total","12089","Nassau",4796650346,1330937204,2419825301,8963984467,15799851435,28,17,16,17,16,17
"2102","0000","COUNTY TOTAL",3794979632,2653871810,955235744,NA,"2014"," NC","County Total","37129","New Hanover",4135978073,1112678636,2067914380,6789849883,7930957705,31,19,15,16,20,21
"2103","0000","COUNTY TOTAL",53903126,51988,1228,NA,"2014"," CT","County Total","09009","New Haven",6913490,9234897,9236125,6965478,60816616,97,62,85,70,67,55
"2104","0000","COUNTY TOTAL",124272,86047,54701,NA,"2014"," CT","County Total","09011","New London",5833909,8348676,8403377,5919956,5958181,118,83,102,104,80,73
"2105","0000","COUNTY TOTAL",530830,302938,129390,NA,"2014"," MA","County Total","44005","Newport",158608,46563,175953,461546,689438,115,104,92,103,93,89
"2106","0000","COUNTY TOTAL",10565593,252800,4574,NA,"2014"," RI","County Total","44005","Newport",376093,27561,32135,628893,10941686,115,104,92,103,93,89
"2107","0000","COUNTY TOTAL",1204183463,744893604,475205188,NA,"2014"," MA","County Total","25021","Norfolk",3798613914,1014453346,1489658534,4543507518,5002797377,42,21,22,20,19,20
"2108","0000","COUNTY TOTAL",80653125114,324896903,50360650,NA,"2014"," MI","County Total","26125","Oakland",113076256,21563178,71923828,437973159,80766201370,5,55,36,48,48,49
"2109","0000","COUNTY TOTAL",68514493,0,0,NA,"2014"," NY","County Total","36067","Onondaga",0,0,0,0,68514493,101,145.5,142.5,142.5,143.5,143.5
"2110","0000","COUNTY TOTAL",37191955958,28715019450,12020042189,NA,"2014"," CA","County Total","06059","Orange",59809081663,9826682627,21846724816,88524101113,97001037621,3,4,4,4,3,4
"2111","0000","COUNTY TOTAL",73360,10206,1065,NA,"2014"," TX","County Total","48361","Orange",0,0,1065,10206,73360,110,98,74,85,118,122
"2112","0000","COUNTY TOTAL",63706237370,4866654823,2698386910,NA,"2014"," LA","County Total","22071","Orleans",5471952710,3686465109,6384852019,10338607533,69178190080,7,12,13,11,17,15
"2113","0000","COUNTY TOTAL",1074759386,0,0,NA,"2014"," FL","County Total","12097","Osceola",0,0,0,0,1074759386,60,145.5,142.5,142.5,143.5,143.5
"2114","0000","COUNTY TOTAL",2354004,0,0,NA,"2014"," NY","County Total","36075","Oswego",38059405,21080886,21080886,38059405,40413409,119,70,106,124,70,65
"2115","0000","COUNTY TOTAL",195067,107800,17421,NA,"2014"," MI","County Total","26139","Ottawa",0,0,17421,107800,195067,139,132,118,123,131,132
"2116","0000","COUNTY TOTAL",2011663518,1365697018,469266298,NA,"2014"," FL","County Total","12099","Palm Beach",331564190,152200298,621466596,1697261208,2343227708,54,29,19,23,39,41
"2117","0000","COUNTY TOTAL",1248936279,0,0,NA,"2014"," ME","County Total","23019","Penobscot",6102633,33315121,33315121,6102633,1255038912,65,84,93,99,88,76
"2118","0000","COUNTY TOTAL",1345739,0,0,NA,"2014"," IL","County Total","17143","Peoria",7010813,80236,80236,7010813,8356552,129,110,130,114,79,96
"2119","0000","COUNTY TOTAL",153273813,80255664,1382853,NA,"2014"," NJ","County Total","42101","Philadelphia",6914029,6797680,8180533,87169693,160187842,94,76,56,76,74,71
"2120","0000","COUNTY TOTAL",11457106276,7993457586,5164573979,NA,"2014"," WA","County Total","53053","Pierce",35973974672,5142596200,10307170179,43967432258,47431080948,12,9,11,9,5,8
"2121","0000","COUNTY TOTAL",1379522,4291,60,NA,"2014"," MA","County Total","25023","Plymouth",218900,4148,4208,223191,1598422,147,102,109,94,103,93
"2122","0000","COUNTY TOTAL",92608,0,0,NA,"2014"," IN","County Total","18127","Porter",11904,2,2,11904,104512,136,119,114,118,116,110
"2123","0000","COUNTY TOTAL",1612154,0,0,NA,"2014"," MI","County Total","26141","Presque Isle",0,0,0,0,1612154,143,133,128,126,143.5,143.5
"2124","0000","COUNTY TOTAL",455109126,632496,92704,NA,"2014"," RI","County Total","44007","Providence",2248474,75194,167898,2880970,457357600,73,51,70,62,37,44
"2125","0000","COUNTY TOTAL",232644,185102,4638,NA,"2014"," WI","County Total","55101","Racine",362925,63205,67843,548027,595569,141,113,94,110,115,104
"2126","0000","COUNTY TOTAL",1476614,0,0,NA,"2014"," SC","County Total","45079","Richland",0,0,0,0,1476614,142,145.5,142.5,142.5,143.5,143.5
"2127","0000","COUNTY TOTAL",223237971,24786161,16829784,NA,"2014"," NH","County Total","33015","Rockingham",43477834,7714141,24543925,68263995,266715805,75,57,54,58,63,50
"2128","0000","COUNTY TOTAL",66644,0,0,NA,"2014"," MI","County Total","26145","Saginaw",6955,396,396,6955,73599,130,78,129,128,91,72
"2129","0000","COUNTY TOTAL",3192914120,294406645,204689811,NA,"2014"," DE","County Total","34033","Salem",730928436,1157353374,1362043185,1025335081,3923842556,46,20,23,29,26,18
"2130","0000","COUNTY TOTAL",922915695,59932938,10728028,NA,"2014"," CA","County Total","06073","San Diego",310967237,495979204,506707232,370900175,1233882932,58,28,45,54,28,23
"2131","0000","COUNTY TOTAL",446259402,3726420,8090681,NA,"2014"," CA","County Total","06077","San Joaquin",81387524,97142923,105233604,85113944,527646926,78,50,71,67,54,40
"2132","0000","COUNTY TOTAL",40924509,0,0,NA,"2014"," WA","County Total","53055","San Juan",154083,98438,98438,154083,41078592,127,127,124,121,117,115
"2133","0000","COUNTY TOTAL",1700164,68675,24000,NA,"2014"," CA","County Total","06079","San Luis Obispo",44146,3141,27141,112821,1744310,138,118,116,113,110,112
"2134","0000","COUNTY TOTAL",1215857006,77378341,8642725,NA,"2014"," CA","County Total","06081","San Mateo",781291957,132049731,140692456,858670298,1997148963,47,38,46,55,22,30
"2135","0000","COUNTY TOTAL",12087979101,973878067,1717124216,NA,"2014"," TX","County Total","48409","San Patricio",101805472,34229328,1751353544,1075683539,12189784573,20,24,27,18,40,39
"2136","0000","COUNTY TOTAL",487150826,347997,484136,NA,"2014"," FL","County Total","12113","Santa Rosa",4716889,2050035,2534171,5064886,491867715,90,80,75,72,71,78
"2137","0000","COUNTY TOTAL",1532170101,492100,74251,NA,"2014"," WA","County Total","53057","Skagit",275324,1622678,1696929,767424,1532445425,66,74,68,61,90,88
"2138","0000","COUNTY TOTAL",211107223,0,0,NA,"2014"," AK","County Total","02230","Skagway",0,0,0,0,211107223,85,129,123,117,124,123
"2139","0000","COUNTY TOTAL",25716468821,86637194,17171360,NA,"2014"," WA","County Total","53061","Snohomish",1334928607,6543721,23715081,1421565801,27051397428,22,61,51,53,24,60
"2140","0000","COUNTY TOTAL",48869561412,295349667,50605238,NA,"2014"," MI","County Total","26147","St. Clair",129209135,33171324,83776562,424558802,48998770547,11,53,26,42,49,58
"2141","0000","COUNTY TOTAL",17641966961,43213213,58331142,NA,"2014"," LA","County Total","22093","St. James",137271620,313465599,371796741,180484833,17779238581,26,34,50,32,52,32
"2142","0000","COUNTY TOTAL",499317837,36749,17488,NA,"2014"," NY","County Total","36089","St. Lawrence",622721,215604,233092,659470,499940558,71,97,110,106,83,87
"2143","0000","COUNTY TOTAL",66141994,740328,198637,NA,"2014"," FL","County Total","12111","St. Lucie",730500,4889383,5088020,1470828,66872494,111,86,87,93,102,77
"2144","0000","COUNTY TOTAL",1739377839,26160857,13611751,NA,"2014"," LA","County Total","22101","St. Mary",14607430,2646616,16258367,40768287,1753985269,52,65,58,59,51,64
"2145","0000","COUNTY TOTAL",124251809,1686292,6858172,NA,"2014"," WA","County Total","53067","Thurston",99647,25382,6883554,1785939,124351456,95,85,86,71,112,118
"2146","0000","COUNTY TOTAL",1150902296,411863658,66455215,NA,"2014"," CA","County Total","06111","Ventura",517204310,401588439,468043654,929067968,1668106606,57,30,30,40,27,25
"2147","0000","COUNTY TOTAL",4241198,2040037,1011832,NA,"2014"," VA","County Total","51812","Virginia Beach",26669103,61629206,62641038,28709140,30910301,19,15,72,65,8.5,9.5
"2148","0000","COUNTY TOTAL",4241198,2040037,1011832,NA,"2014"," VA","County Total","51812","Virginia Beach",38818363861,7668399704,7669411536,38820403898,38822605059,19,15,72,65,8.5,9.5
"2149","0000","COUNTY TOTAL",30691040886,21685205569,7268178524,NA,"2014"," VA","County Total","51811","Virginia Beach",26669103,61629206,7329807730,21711874672,30717709989,9,7,5,6,8.5,9.5
"2150","0000","COUNTY TOTAL",30691040886,21685205569,7268178524,NA,"2014"," VA","County Total","51811","Virginia Beach",38818363861,7668399704,14936578228,60503569430,69509404747,9,7,5,6,8.5,9.5
"2151","0000","COUNTY TOTAL",822238,0,0,NA,"2014"," WV","County Total","51813","Virginia Beach",0,0,0,0,822238,151,145.5,142.5,142.5,143.5,143.5
"2152","0000","COUNTY TOTAL",584100086,0,0,NA,"2014"," NC","County Total","37183","Wake",0,0,0,0,584100086,82,145.5,142.5,142.5,143.5,143.5
"2153","0000","COUNTY TOTAL",188785,0,0,NA,"2014"," ME","County Total","23027","Waldo",25104195,2037351,2037351,25104195,25292980,104,72,105,98,65,67
"2154","0000","COUNTY TOTAL",521660,0,0,NA,"2014"," VA","County Total","51187","Warren",0,0,0,0,521660,153,145.5,142.5,142.5,143.5,143.5
"2155","0000","COUNTY TOTAL",2053077663,6033930,2150721,NA,"2014"," ME","County Total","23029","Washington",10032,2843,2153564,6043962,2053087695,59,66,62,51,101,98
"2156","0000","COUNTY TOTAL",5282872253,623106306,544691773,NA,"2014"," OR","County Total","41067","Washington",1958731429,1000182656,1544874429,2581837735,7241603682,43,26,29,27,29,33
"2157","0000","COUNTY TOTAL",167358080,2892438,99404,NA,"2014"," WI","County Total","55133","Waukesha",5887901,17409948,17509352,8780339,173245981,91,75,65,86,72,69
"2158","0000","COUNTY TOTAL",1048200,0,0,NA,"2014"," NY","County Total","36117","Wayne",51101,8084,8084,51101,1099301,137,131,142.5,142.5,122,121
"2159","0000","COUNTY TOTAL",6976264308,23797161,92333668,NA,"2014"," LA","County Total","22121","West Baton Rouge",395248131,529324590,621658258,419045292,7371512439,33,31,53,31,43,29
"2160","0000","COUNTY TOTAL",20665364477,119098832,36690761,NA,"2014"," WA","County Total","53073","Whatcom",15205623,1727424,38418185,134304455,20680570100,24,69,47,56,68,80
"2161","0000","COUNTY TOTAL",774067907,17409282,42057004,NA,"2014"," OH","County Total","39173","Wood",4382935,6419675,48476679,21792217,778450842,74,64,81,68,64,59
"2162","0000","COUNTY TOTAL",1826606,0,0,NA,"2014"," MA","County Total","25027","Worcester",0,0,0,0,1826606,102,115,96,102,143.5,143.5
"2163","0000","COUNTY TOTAL",14991849,14892103,9288413,NA,"2014"," AK","County Total","02275","Wrangell",0,0,9288413,14892103,14991849,132,87,67,73,125,130
"2164","0000","COUNTY TOTAL",630167462,0,0,NA,"2014"," NC","County Total","45091","York",0,0,0,0,630167462,72,145.5,142.5,142.5,143.5,143.5
"2165","0000","COUNTY TOTAL",19582278059,13905955931,6220656714,NA,"2015"," CA","County Total","06001","Alameda",25789795380,6547655658,12768312372,39695751311,45372073439,10,5,7,7,7,6
"2166","0000","COUNTY TOTAL",783872033,3199468,174641,NA,"2015"," NY","County Total","36001","Albany",24571574,136174082,136348723,27771042,808443607,76,56,61,77,57,48
"2167","0000","COUNTY TOTAL",54434621,0,0,NA,"2015"," PA","County Total","42003","Allegheny",0,0,0,0,54434621,98,145.5,142.5,142.5,143.5,143.5
"2168","0000","COUNTY TOTAL",10983469,0,0,NA,"2015"," MI","County Total","26007","Alpena",0,0,0,0,10983469,126,135,127,130,129,125
"2169","0000","COUNTY TOTAL",8041320,1591250,329864,NA,"2015"," MD","County Total","24003","Anne Arundel",3738295,485149,815013,5329545,11779615,114,91,73,81,76,83
"2170","0000","COUNTY TOTAL",5055130471,5013755,605071,NA,"2015"," DC","County Total","51013","Arlington",2385174,299370,904441,7398929,5057515645,40,81,77,84,66,74
"2171","0000","COUNTY TOTAL",1035968583,0,0,NA,"2015"," ME","County Total","23003","Aroostook",0,0,0,0,1035968583,64,145.5,142.5,142.5,143.5,143.5
"2172","0000","COUNTY TOTAL",3656436288,1311446078,1271038164,NA,"2015"," AL","County Total","01003","Baldwin",3512570972,1255796308,2526834472,4824017050,7169007260,30,18,18,15,18,19
"2173","0000","COUNTY TOTAL",15373718236,4833056395,1439409270,NA,"2015"," MD","County Total","24005","Baltimore",16095327304,4535912555,5975321825,20928383699,31469045540,15,11,12,12,10,7
"2174","0000","COUNTY TOTAL",570633311,237024005,77910844,NA,"2015"," FL","County Total","12005","Bay",657267002,116012659,193923503,894291007,1227900313,63,47,34,43,31,45
"2175","0000","COUNTY TOTAL",3420609157,890362941,1026486040,NA,"2015"," TX","County Total","48039","Brazoria",254437959,327573037,1354059077,1144800900,3675047116,38,23,25,19,41,34
"2176","0000","COUNTY TOTAL",51355887,759466,249376,NA,"2015"," FL","County Total","12009","Brevard",3525663,3179580,3428956,4285129,54881550,92,58,66,63,60,51
"2177","0000","COUNTY TOTAL",358500,180800,8471,NA,"2015"," MA","County Total","25005","Bristol",10760409,6093077,6101548,10941209,11118909,124,92,98,105,77,79
"2178","0000","COUNTY TOTAL",37319504685,27377435866,7152029658,NA,"2015"," NY","County Total","36005","Bronx",8831245810,2618290413,9770320071,36208681676,46150750495,14,8,3,5,13,16
"2179","0000","COUNTY TOTAL",13244271954,8739633262,2048092659,NA,"2015"," FL","County Total","12011","Broward",8556182005,2901328525,4949421184,17295815267,21800453959,21,14,9,14,15,14
"2180","0000","COUNTY TOTAL",41439603,287987,86933,NA,"2015"," WI","County Total","55009","Brown",1813157,127580,214513,2101144,43252760,86,71,90,95,84,66
"2181","0000","COUNTY TOTAL",4254349505,1858402672,576800081,NA,"2015"," PA","County Total","42017","Bucks",8269508319,2998434641,3575234722,10127910991,12523857824,27,16,17,24,14,13
"2182","0000","COUNTY TOTAL",22471581,0,0,NA,"2015"," LA","County Total","22017","Caddo ",0,0,0,0,22471581,109,145.5,142.5,142.5,143.5,143.5
"2183","0000","COUNTY TOTAL",4059514151,88015137,96622329,NA,"2015"," LA","County Total","22019","Calcasieu",8696456,53722358,150344687,96711593,4068210607,35,41,48,34,47,36
"2184","0000","COUNTY TOTAL",668980485,16656115,89161100,NA,"2015"," TX","County Total","48057","Calhoun",171648196,306289902,395451002,188304311,840628681,67,43,63,46,44,35
"2185","0000","COUNTY TOTAL",6221767503,39033906,139270579,NA,"2015"," TX","County Total","22023","Cameron",151794698,258081310,397351889,190828604,6373562201,32,36,49,28,53,43
"2186","0000","COUNTY TOTAL",265479620,56984,18601,NA,"2015"," NC","County Total","37031","Carteret",192643061,163304310,163322911,192700045,458122681,79,54,95,79,42,47
"2187","0000","COUNTY TOTAL",6740913903,593114136,525055039,NA,"2015"," TX","County Total","48071","Chambers",4727142,2022959,527077998,597841278,6745641045,37,40,28,25,82,75
"2188","0000","COUNTY TOTAL",31630881399,15111060074,5456101978,NA,"2015"," SC","County Total","45019","Charleston",45258135848,7129843211,12585945189,60369195922,76889017247,6,6,8,8,4,5
"2189","0000","COUNTY TOTAL",49319,0,0,NA,"2015"," MS","County Total","05017","Chicot",0,0,0,0,49319,152,120,122,120,114,108
"2190","0000","COUNTY TOTAL",1133521095,151713,36127,NA,"2015"," MI","County Total","26033","Chippewa",349681,14765,50892,501394,1133870776,62,73,79,96,94,68
"2191","0000","COUNTY TOTAL",526595436,186979,2368,NA,"2015"," WA","County Total","53009","Clallam",89654,20610,22978,276633,526685090,93,116,117,111,107,106
"2192","0000","COUNTY TOTAL",1763056597,38677426,69204582,NA,"2015"," WA","County Total","53011","Clark",43261818,53747815,122952397,81939244,1806318415,53,48,52,38,58,56
"2193","0000","COUNTY TOTAL",47418585,1082487,396193,NA,"2015"," OR","County Total","41007","Clatsop",3281815,58904,455097,4364302,50700400,105,105,101,101,86,91
"2194","0000","COUNTY TOTAL",13868067477,0,0,NA,"2015"," GA","County Total","13067","Cobb",0,0,0,0,13868067477,25,145.5,142.5,142.5,143.5,143.5
"2195","0000","COUNTY TOTAL",640947175,22307620,21991867,NA,"2015"," CA","County Total","06013","Contra Costa",23372608,45931650,67923517,45680228,664319783,68,59,57,49,45,62
"2196","0000","COUNTY TOTAL",131153511,0,0,NA,"2015"," OR","County Total","41011","Coos",0,0,0,0,131153511,89,79,104,69,113,81
"2197","0000","COUNTY TOTAL",5165189830,22717088,121974202,NA,"2015"," WA","County Total","53015","Cowlitz",9448959,23441572,145415774,32166047,5174638789,39,46,55,33,59,54
"2198","0000","COUNTY TOTAL",198593997,106656508,31999664,NA,"2015"," ME","County Total","23005","Cumberland",264963462,73561838,105561502,371619970,463557459,70,49,35,50,36,46
"2199","0000","COUNTY TOTAL",25973803062,41424717,10207420,NA,"2015"," OH","County Total","39035","Cuyahoga",123152387,30749865,40957285,164577104,26096955449,16,60,59,64,46,53
"2200","0000","COUNTY TOTAL",259123986,32541,23757,NA,"2015"," NJ","County Total","42045","Delaware",50241,10029,33786,82782,259174227,45,27,21,35,21,26
"2201","0000","COUNTY TOTAL",1927112459,1628887336,259079693,NA,"2015"," PA","County Total","42045","Delaware",3415993488,608245810,867325503,5044880824,5343105947,45,27,21,35,21,26
"2202","0000","COUNTY TOTAL",3048197,0,0,NA,"2015"," MI","County Total","26041","Delta",358988,45122,45122,358988,3407185,140,123,126,129,109,109
"2203","0000","COUNTY TOTAL",403649770,1419365,197425,NA,"2015"," WI","County Total","55031","Douglas",99348524,15308689,15506114,100767889,502998294,77,68,84,78,56,61
"2204","0000","COUNTY TOTAL",46405933514,115747436,36116740,NA,"2015"," IL","County Total","17043","DuPage",581692189,273414847,309531587,697439625,46987625703,8,45,39,45,35,38
"2205","0000","COUNTY TOTAL",27913456793,18347439859,10678588904,NA,"2015"," GA","County Total","13103","Effingham",57852058061,11365955409,22044544313,76199497920,85765514854,4,2,6,3,2,2
"2206","0000","COUNTY TOTAL",47232009270,224916531,25750139,NA,"2015"," NY","County Total","36029","Erie",70443879,9732863,35483002,295360410,47302453149,13,63,33,52,55,63
"2207","0000","COUNTY TOTAL",2112110,0,0,NA,"2015"," OH","County Total","39043","Erie",219887,7702,7702,219887,2331997,108,109,142.5,142.5,85,92
"2208","0000","COUNTY TOTAL",23784714,0,0,NA,"2015"," PA","County Total","42049","Erie",885550,139337,139337,885550,24670264,113,94,113,125,73,85
"2209","0000","COUNTY TOTAL",1437783,652336,460785,NA,"2015"," MA","County Total","25009","Essex",37530639,6840409,7301194,38182975,38968422,125,90,88,83,75,82
"2210","0000","COUNTY TOTAL",1482319,0,0,NA,"2015"," AK","County Total","02090","Fairbanks North Star",0,0,0,0,1482319,117,121,119,108,143.5,143.5
"2211","0000","COUNTY TOTAL",89871720,36366,24962,NA,"2015"," VA","County Total","51059","Fairfax",0,0,24962,36366,89871720,107,107,108,92,123,120
"2212","0000","COUNTY TOTAL",1328324,102220,19927,NA,"2015"," CT","County Total","09001","Fairfield",0,0,19927,102220,1328324,134,126,121,116,121,117
"2213","0000","COUNTY TOTAL",167635690,0,0,NA,"2015"," OH","County Total","39045","Fairfield",0,0,0,0,167635690,81,145.5,142.5,142.5,143.5,143.5
"2214","0000","COUNTY TOTAL",24403898,0,0,NA,"2015"," NC","County Total","37067","Forsyth",0,0,0,0,24403898,103,145.5,142.5,142.5,143.5,143.5
"2215","0000","COUNTY TOTAL",2359609283,182262684,93642489,NA,"2015"," TX","County Total","48167","Galveston",740782567,334406852,428049341,923045251,3100391850,49,37,37,41,32,31
"2216","0000","COUNTY TOTAL",179342,179342,68736,NA,"2015"," SC","County Total","45043","Georgetown",685857,90022,158758,865199,865199,133,93,97,97,81,86
"2217","0000","COUNTY TOTAL",5867352948,116874506,113825442,NA,"2015"," GA","County Total","13127","Glynn",367522481,29895149,143720591,484396987,6234875429,36,52,32,44,30,52
"2218","0000","COUNTY TOTAL",2497939925,7085326,752335,NA,"2015"," WA","County Total","53027","Grays Harbor",5857741,23826204,24578539,12943067,2503797666,55,67,40,57,62,70
"2219","0000","COUNTY TOTAL",5401835284,0,0,NA,"2015"," OH","County Total","39061","Hamilton",0,0,0,0,5401835284,41,145.5,142.5,142.5,143.5,143.5
"2220","0000","COUNTY TOTAL",5875750546,27674438,24551888,NA,"2015"," TX","County Total","48199","Hardin",139520586,324249300,348801188,167195024,6015271132,29,39,41,30,50,37
"2221","0000","COUNTY TOTAL",694749393,524568727,348909056,NA,"2015"," MS","County Total","28047","Harrison",1385293360,919068573,1267977629,1909862087,2080042753,51,22,24,21,23,22
"2222","0000","COUNTY TOTAL",339519354,10881,23,NA,"2015"," CT","County Total","09003","Hartford",0,0,23,10881,339519354,83,114,112,115,87,101
"2223","0000","COUNTY TOTAL",345473272,10320753,7180776,NA,"2015"," HI","County Total","15001","Hawaii",1724983,255092,7435868,12045736,347198255,88,77,64,60,95,95
"2224","0000","COUNTY TOTAL",2016868279,0,0,NA,"2015"," MN","County Total","27054","Hennepin",0,0,0,0,2016868279,61,145.5,142.5,142.5,143.5,143.5
"2225","0000","COUNTY TOTAL",2364240188,62114151,84233723,NA,"2015"," FL","County Total","12057","Hillsborough",606044780,383945886,468179609,668158931,2970284968,50,32,44,39,25,27
"2226","0000","COUNTY TOTAL",440019093,95351644,121651385,NA,"2015"," HI","County Total","15003","Honolulu",473392859,181815520,303466905,568744503,913411952,69,25,43,37,34,24
"2227","0000","COUNTY TOTAL",167622668,133367,71500,NA,"2015"," AK","County Total","02105","Hoonah-Angoon",0,0,71500,133367,167622668,84,103,82,89,108,119
"2228","0000","COUNTY TOTAL",7584545,27773,105348,NA,"2015"," CA","County Total","06023","Humboldt",1350319,54357,159705,1378092,8934864,116,82,103,66,89,97
"2229","0000","COUNTY TOTAL",3573837875,179183592,303013749,NA,"2015"," MS","County Total","28059","Jackson",269193,45907,303059656,179452785,3574107068,48,42,31,26,69,84
"2230","0000","COUNTY TOTAL",2386434,0,0,NA,"2015"," AL","County Total","01073","Jefferson",0,0,0,0,2386434,100,145.5,142.5,142.5,143.5,143.5
"2231","0000","COUNTY TOTAL",6416216656,177172,52063,NA,"2015"," NY","County Total","36045","Jefferson",4723907,15775,67838,4901079,6420940563,34,96,69,82,78,99
"2232","0000","COUNTY TOTAL",809657693,805904268,1920957,NA,"2015"," WA","County Total","53031","Jefferson",456600,56882,1977839,806360868,810114293,87,101,38,88,98,111
"2233","0000","COUNTY TOTAL",12236162,0,0,NA,"2015"," MI","County Total","26081","Kent",0,0,0,0,12236162,128,145.5,142.5,142.5,143.5,143.5
"2234","0000","COUNTY TOTAL",64752080,80000,18144,NA,"2015"," AK","County Total","02130","Ketchikan Gateway",17369,3346,21490,97369,64769449,99,99,89,90,97,90
"2235","0000","COUNTY TOTAL",7150159055,3949287258,3644835514,NA,"2015"," WA","County Total","53035","Kitsap",14575628801,3363593820,7008429334,18524916059,21725787856,17,10,14,10,11,11
"2236","0000","COUNTY TOTAL",161761,0,0,NA,"2015"," ME","County Total","23013","Knox",0,0,0,0,161761,149,136,142.5,142.5,130,126
"2237","0000","COUNTY TOTAL",4812021464,132225105,121769372,NA,"2015"," MN","County Total","27071","Koochiching",774511476,169405572,291174944,906736581,5586532940,44,44,42,36,33,42
"2238","0000","COUNTY TOTAL",3053434,0,0,NA,"2015"," OR","County Total","41041","Lincoln",15236,632,632,15236,3068670,135,100,83,87,128,128
"2239","0000","COUNTY TOTAL",79646,15249,1229,NA,"2015"," OH","County Total","39093","Lorain",456416,100675,101904,471665,536062,122,117,125,127,99,107
"2240","0000","COUNTY TOTAL",31716873671,25337360502,11138449413,NA,"2015"," CA","County Total","06037","Los Angeles",211494416366,36720954669,47859404082,236831776868,243211290037,1,1,1,1,1,1
"2241","0000","COUNTY TOTAL",1328870,0,0,NA,"2015"," MS","County Total","22065","Madison",0,0,0,0,1328870,148,124,142.5,142.5,120,113
"2242","0000","COUNTY TOTAL",110262911,8652303,6283946,NA,"2015"," FL","County Total","12081","Manatee",217921171,390913351,397197297,226573474,328184082,80,35,60,47,38,28
"2243","0000","COUNTY TOTAL",16313,4763,391,NA,"2015"," WI","County Total","55071","Manitowoc",0,0,391,4763,16313,150,122,111,109,126,129
"2244","0000","COUNTY TOTAL",42483,0,0,NA,"2015"," WI","County Total","55075","Marinette",0,0,0,0,42483,144,130,107,119,132,131
"2245","0000","COUNTY TOTAL",93055187,0,0,NA,"2015"," MI","County Total","26103","Marquette",0,0,0,0,93055187,96,125,142.5,142.5,106,114
"2246","0000","COUNTY TOTAL",18191007669,2014769024,778129645,NA,"2015"," AK","County Total","02170","Matanuska-Susitna",50316004,44308076,822437721,2065085028,18241323673,23,33,20,22,61,57
"2247","0000","COUNTY TOTAL",5467190,2780812,1727667,NA,"2015"," HI","County Total","15009","Maui",91758,26504,1754171,2872570,5558948,121,89,76,75,105,105
"2248","0000","COUNTY TOTAL",10291648053,7083641906,1791702736,NA,"2015"," FL","County Total","12086","Miami-Dade",13877799496,3244583581,5036286317,20961441402,24169447549,18,13,10,13,12,12
"2249","0000","COUNTY TOTAL",64583401,6027652,2318991,NA,"2015"," FL","County Total","12087","Monroe",132601,64396,2383387,6160253,64716002,106,95,78,80,100,103
"2250","0000","COUNTY TOTAL",6374094,291341,55271,NA,"2015"," NY","County Total","36055","Monroe",1122550,50207,105478,1413891,7496644,123,108,100,100,96,100
"2251","0000","COUNTY TOTAL",1853158,1255751,170605,NA,"2015"," CA","County Total","06053","Monterey",0,0,170605,1255751,1853158,131,88,80,74,111,116
"2252","0000","COUNTY TOTAL",13341456,0,0,NA,"2015"," OH","County Total","39113","Montgomery",0,0,0,0,13341456,112,145.5,142.5,142.5,143.5,143.5
"2253","0000","COUNTY TOTAL",76796022691,29111735721,11510378859,NA,"2015"," TX","County Total","48339","Montgomery",30002201078,9494722850,21005101709,59113936799,106798223769,2,3,2,2,6,3
"2254","0000","COUNTY TOTAL",2652280164,515503,167208,NA,"2015"," AL","County Total","01103","Morgan",0,0,167208,515503,2652280164,56,106,91,91,143.5,143.5
"2255","0000","COUNTY TOTAL",875718,692052,106199,NA,"2015"," MI","County Total","26121","Muskegon",0,0,106199,692052,875718,146,112,99,107,104,102
"2256","0000","COUNTY TOTAL",8354343327,3140461473,919569011,NA,"2015"," FL","County Total","12089","Nassau",4984102019,3863528846,4783097857,8124563492,13338445346,28,17,16,17,16,17
"2257","0000","COUNTY TOTAL",3755850297,2612091111,8.88e+08,NA,"2015"," NC","County Total","37129","New Hanover",4397490322,1213182133,2101182120,7009581433,8153340619,31,19,15,16,20,21
"2258","0000","COUNTY TOTAL",32007361,0,0,NA,"2015"," CT","County Total","09009","New Haven",13907988,69210108,69210108,13907988,45915349,97,62,85,70,67,55
"2259","0000","COUNTY TOTAL",185058,14046,340,NA,"2015"," CT","County Total","09011","New London",4991199,4682537,4682877,5005245,5176257,118,83,102,104,80,73
"2260","0000","COUNTY TOTAL",510685,400258,5548,NA,"2015"," MA","County Total","44005","Newport",290607,64979,70527,690865,801292,115,104,92,103,93,89
"2261","0000","COUNTY TOTAL",25849037,815763,73430,NA,"2015"," RI","County Total","44005","Newport",125790,63702,137132,941553,25974827,115,104,92,103,93,89
"2262","0000","COUNTY TOTAL",1014368039,630978459,488089008,NA,"2015"," MA","County Total","25021","Norfolk",4046975635,1111562254,1599651262,4677954094,5061343674,42,21,22,20,19,20
"2263","0000","COUNTY TOTAL",74419652342,123722641,22743676,NA,"2015"," MI","County Total","26125","Oakland",110426613,24753413,47497089,234149254,74530078955,5,55,36,48,48,49
"2264","0000","COUNTY TOTAL",46405000,0,0,NA,"2015"," NY","County Total","36067","Onondaga",0,0,0,0,46405000,101,145.5,142.5,142.5,143.5,143.5
"2265","0000","COUNTY TOTAL",31103943018,24295337825,10337892040,NA,"2015"," CA","County Total","06059","Orange",54224272172,9881394052,20219286092,78519609997,85328215190,3,4,4,4,3,4
"2266","0000","COUNTY TOTAL",90026871,25837241,4712396,NA,"2015"," TX","County Total","48361","Orange",0,0,4712396,25837241,90026871,110,98,74,85,118,122
"2267","0000","COUNTY TOTAL",56190287151,4859694625,3284210587,NA,"2015"," LA","County Total","22071","Orleans",5007804386,3398178195,6682388782,9867499011,61198091537,7,12,13,11,17,15
"2268","0000","COUNTY TOTAL",2074866952,0,0,NA,"2015"," FL","County Total","12097","Osceola",0,0,0,0,2074866952,60,145.5,142.5,142.5,143.5,143.5
"2269","0000","COUNTY TOTAL",2046040,0,0,NA,"2015"," NY","County Total","36075","Oswego",7057206,3486247,3486247,7057206,9103246,119,70,106,124,70,65
"2270","0000","COUNTY TOTAL",1792103135,1405761391,486356034,NA,"2015"," FL","County Total","12099","Palm Beach",260340951,117395841,603751875,1666102342,2052444086,54,29,19,23,39,41
"2271","0000","COUNTY TOTAL",942618887,590212,71334,NA,"2015"," ME","County Total","23019","Penobscot",33581,9100,80434,623793,942652468,65,84,93,99,88,76
"2272","0000","COUNTY TOTAL",5423531,16597,1e+05,NA,"2015"," IL","County Total","17143","Peoria",863810,143467,243467,880407,6287341,129,110,130,114,79,96
"2273","0000","COUNTY TOTAL",69598673,1332450,1767185,NA,"2015"," NJ","County Total","42101","Philadelphia",23567846,32231752,33998937,24900296,93166519,94,76,56,76,74,71
"2274","0000","COUNTY TOTAL",10074277247,7211778076,4957674264,NA,"2015"," WA","County Total","53053","Pierce",36856691646,5347340690,10305014954,44068469722,46930968893,12,9,11,9,5,8
"2275","0000","COUNTY TOTAL",758402,0,0,NA,"2015"," MA","County Total","25023","Plymouth",115298,6334,6334,115298,873700,147,102,109,94,103,93
"2276","0000","COUNTY TOTAL",12035,4800,2005,NA,"2015"," IN","County Total","18127","Porter",2220,1,2006,7020,14255,136,119,114,118,116,110
"2277","0000","COUNTY TOTAL",251031,13500,11442,NA,"2015"," MI","County Total","26141","Presque Isle",0,0,11442,13500,251031,143,133,128,126,143.5,143.5
"2278","0000","COUNTY TOTAL",214567266,44700,13463,NA,"2015"," RI","County Total","44007","Providence",26417014,2295150,2308613,26461714,240984280,73,51,70,62,37,44
"2279","0000","COUNTY TOTAL",170395,22779,5162,NA,"2015"," WI","County Total","55101","Racine",379612,270800,275962,402391,550007,141,113,94,110,115,104
"2280","0000","COUNTY TOTAL",3572440,0,0,NA,"2015"," SC","County Total","45079","Richland",0,0,0,0,3572440,142,145.5,142.5,142.5,143.5,143.5
"2281","0000","COUNTY TOTAL",367390424,95733126,9453967,NA,"2015"," NH","County Total","33015","Rockingham",21287610,4504780,13958747,117020736,388678034,75,57,54,58,63,50
"2282","0000","COUNTY TOTAL",13000,0,0,NA,"2015"," MI","County Total","26145","Saginaw",252996,8130493,8130493,252996,265996,130,78,129,128,91,72
"2283","0000","COUNTY TOTAL",3166068064,296651411,200730721,NA,"2015"," DE","County Total","34033","Salem",728242663,1314739909,1515470630,1024894074,3894310727,46,20,23,29,26,18
"2284","0000","COUNTY TOTAL",958158964,110273486,16669857,NA,"2015"," CA","County Total","06073","San Diego",372522945,532492258,549162115,482796431,1330681909,58,28,45,54,28,23
"2285","0000","COUNTY TOTAL",372647932,535223,89253,NA,"2015"," CA","County Total","06077","San Joaquin",102570415,189403744,189492997,103105638,475218347,78,50,71,67,54,40
"2286","0000","COUNTY TOTAL",3907134,0,0,NA,"2015"," WA","County Total","53055","San Juan",95856,17317,17317,95856,4002990,127,127,124,121,117,115
"2287","0000","COUNTY TOTAL",3047789,0,0,NA,"2015"," CA","County Total","06079","San Luis Obispo",172376,46062,46062,172376,3220165,138,118,116,113,110,112
"2288","0000","COUNTY TOTAL",694005078,51160319,7543659,NA,"2015"," CA","County Total","06081","San Mateo",524213145,195318142,202861801,575373464,1218218223,47,38,46,55,22,30
"2289","0000","COUNTY TOTAL",9923075714,570248700,1396710839,NA,"2015"," TX","County Total","48409","San Patricio",212358940,65314218,1462025057,782607640,10135434654,20,24,27,18,40,39
"2290","0000","COUNTY TOTAL",373946153,485269,116824,NA,"2015"," FL","County Total","12113","Santa Rosa",8628303,274576,391400,9113572,382574456,90,80,75,72,71,78
"2291","0000","COUNTY TOTAL",854265896,194783,57582,NA,"2015"," WA","County Total","53057","Skagit",271276,8260,65842,466059,854537172,66,74,68,61,90,88
"2292","0000","COUNTY TOTAL",127976097,0,0,NA,"2015"," AK","County Total","02230","Skagway",0,0,0,0,127976097,85,129,123,117,124,123
"2293","0000","COUNTY TOTAL",29846324248,56534845,10306696,NA,"2015"," WA","County Total","53061","Snohomish",1649809251,13264133,23570829,1706344096,31496133499,22,61,51,53,24,60
"2294","0000","COUNTY TOTAL",42938103293,306176013,56079641,NA,"2015"," MI","County Total","26147","St. Clair",125195695,35239194,91318835,431371708,43063298988,11,53,26,42,49,58
"2295","0000","COUNTY TOTAL",13540031911,24969379,58644428,NA,"2015"," LA","County Total","22093","St. James",80610919,342479117,401123545,105580298,13620642830,26,34,50,32,52,32
"2296","0000","COUNTY TOTAL",482998495,43919,19848,NA,"2015"," NY","County Total","36089","St. Lawrence",1004058,106534,126382,1047977,484002553,71,97,110,106,83,87
"2297","0000","COUNTY TOTAL",9517018,258743,201236,NA,"2015"," FL","County Total","12111","St. Lucie",63965,5807100,6008336,322708,9580983,111,86,87,93,102,77
"2298","0000","COUNTY TOTAL",1290496847,9113128,13772053,NA,"2015"," LA","County Total","22101","St. Mary",38455802,2915902,16687955,47568930,1328952649,52,65,58,59,51,64
"2299","0000","COUNTY TOTAL",93835500,27373,2386,NA,"2015"," WA","County Total","53067","Thurston",172179,3300,5686,199552,94007679,95,85,86,71,112,118
"2300","0000","COUNTY TOTAL",963118904,318988980,85600837,NA,"2015"," CA","County Total","06111","Ventura",647222988,501989523,587590360,966211968,1610341892,57,30,30,40,27,25
"2301","0000","COUNTY TOTAL",25627468,2592943,1118965,NA,"2015"," VA","County Total","51812","Virginia Beach",7150340,52073002,53191967,9743283,32777808,19,15,72,65,8.5,9.5
"2302","0000","COUNTY TOTAL",25627468,2592943,1118965,NA,"2015"," VA","County Total","51812","Virginia Beach",41022588625,8297830130,8298949095,41025181568,41048216093,19,15,72,65,8.5,9.5
"2303","0000","COUNTY TOTAL",28668887188,20324376900,7214047229,NA,"2015"," VA","County Total","51811","Virginia Beach",7150340,52073002,7266120231,20331527240,28676037528,9,7,5,6,8.5,9.5
"2304","0000","COUNTY TOTAL",28668887188,20324376900,7214047229,NA,"2015"," VA","County Total","51811","Virginia Beach",41022588625,8297830130,15511877359,61346965525,69691475813,9,7,5,6,8.5,9.5
"2305","0000","COUNTY TOTAL",12644,0,0,NA,"2015"," WV","County Total","51813","Virginia Beach",0,0,0,0,12644,151,145.5,142.5,142.5,143.5,143.5
"2306","0000","COUNTY TOTAL",294993367,0,0,NA,"2015"," NC","County Total","37183","Wake",0,0,0,0,294993367,82,145.5,142.5,142.5,143.5,143.5
"2307","0000","COUNTY TOTAL",2228626,115705,61215,NA,"2015"," ME","County Total","23027","Waldo",15296985,1139303,1200518,15412690,17525611,104,72,105,98,65,67
"2308","0000","COUNTY TOTAL",1494100098,8428116,15641738,NA,"2015"," ME","County Total","23029","Washington",197394,26143,15667881,8625510,1494297492,59,66,62,51,101,98
"2309","0000","COUNTY TOTAL",3766353230,155570070,181593679,NA,"2015"," OR","County Total","41067","Washington",307014277,133762403,315356082,462584347,4073367507,43,26,29,27,29,33
"2310","0000","COUNTY TOTAL",253088700,2812878,386351,NA,"2015"," WI","County Total","55133","Waukesha",8722310,435946,822297,11535188,261811010,91,75,65,86,72,69
"2311","0000","COUNTY TOTAL",5320087490,34531073,147696930,NA,"2015"," LA","County Total","22121","West Baton Rouge",249967871,464906338,612603268,284498944,5570055361,33,31,53,31,43,29
"2312","0000","COUNTY TOTAL",18422648816,92073987,27580895,NA,"2015"," WA","County Total","53073","Whatcom",13333526,4572172,32153067,105407513,18435982342,24,69,47,56,68,80
"2313","0000","COUNTY TOTAL",521047467,0,0,NA,"2015"," OH","County Total","39173","Wood",5049315,2255806,2255806,5049315,526096782,74,64,81,68,64,59
"2314","0000","COUNTY TOTAL",1881867,69283,26651,NA,"2015"," MA","County Total","25027","Worcester",0,0,26651,69283,1881867,102,115,96,102,143.5,143.5
"2315","0000","COUNTY TOTAL",13446876,13394008,7174793,NA,"2015"," AK","County Total","02275","Wrangell",5622,915,7175708,13399630,13452498,132,87,67,73,125,130
"2316","0000","COUNTY TOTAL",760762209,0,0,NA,"2015"," NC","County Total","45091","York",0,0,0,0,760762209,72,145.5,142.5,142.5,143.5,143.5
"2317","0000","COUNTY TOTAL",19850433902,15059795540,7271509239,NA,"2016"," CA","County Total","06001","Alameda",26147811886,6649333502,13920842741,41207607426,45998245788,10,5,7,7,7,6
"2318","0000","COUNTY TOTAL",283136873,7388662,468460,NA,"2016"," NY","County Total","36001","Albany",44370207,9272733,9741193,51758869,327507080,76,56,61,77,57,48
"2319","0000","COUNTY TOTAL",64937714,0,0,NA,"2016"," PA","County Total","42003","Allegheny",0,0,0,0,64937714,98,145.5,142.5,142.5,143.5,143.5
"2320","0000","COUNTY TOTAL",7682141,0,0,NA,"2016"," MI","County Total","26007","Alpena",10393,17313,17313,10393,7692534,126,135,127,130,129,125
"2321","0000","COUNTY TOTAL",4628047,1861859,719271,NA,"2016"," MD","County Total","24003","Anne Arundel",20904486,1274796,1994067,22766345,25532533,114,91,73,81,76,83
"2322","0000","COUNTY TOTAL",5016575039,1879563,224113,NA,"2016"," DC","County Total","51013","Arlington",18098016,10616290,10840403,19977579,5034673055,40,81,77,84,66,74
"2323","0000","COUNTY TOTAL",1143038734,0,0,NA,"2016"," ME","County Total","23003","Aroostook",0,0,0,0,1143038734,64,145.5,142.5,142.5,143.5,143.5
"2324","0000","COUNTY TOTAL",4307045743,1595285918,1395055653,NA,"2016"," AL","County Total","01003","Baldwin",3697759745,1285280023,2680335676,5293045663,8004805488,30,18,18,15,18,19
"2325","0000","COUNTY TOTAL",14061033233,5863687845,1959517792,NA,"2016"," MD","County Total","24005","Baltimore",15322255747,4553174936,6512692728,21185943592,29383288980,15,11,12,12,10,7
"2326","0000","COUNTY TOTAL",497543028,209127830,71395149,NA,"2016"," FL","County Total","12005","Bay",494524671,100592849,171987998,703652501,992067699,63,47,34,43,31,45
"2327","0000","COUNTY TOTAL",3407797501,923222272,1280986277,NA,"2016"," TX","County Total","48039","Brazoria",244781440,308768114,1589754391,1168003712,3652578941,38,23,25,19,41,34
"2328","0000","COUNTY TOTAL",59044059,17508673,19649093,NA,"2016"," FL","County Total","12009","Brevard",23699092,97852235,117501328,41207765,82743151,92,58,66,63,60,51
"2329","0000","COUNTY TOTAL",559157,559157,31404,NA,"2016"," MA","County Total","25005","Bristol",8334354,4747781,4779185,8893511,8893511,124,92,98,105,77,79
"2330","0000","COUNTY TOTAL",32145016682,25225942602,7803891180,NA,"2016"," NY","County Total","36005","Bronx",7953745645,2159018770,9962909950,33179688247,40098762327,14,8,3,5,13,16
"2331","0000","COUNTY TOTAL",11707711101,8986905429,1761986388,NA,"2016"," FL","County Total","12011","Broward",8634037467,3135766140,4897752528,17620942896,20341748568,21,14,9,14,15,14
"2332","0000","COUNTY TOTAL",292061200,35716,51885,NA,"2016"," WI","County Total","55009","Brown",3260562,8235681,8287566,3296278,295321762,86,71,90,95,84,66
"2333","0000","COUNTY TOTAL",4264203093,1653203904,481089519,NA,"2016"," PA","County Total","42017","Bucks",7543926716,3099834603,3580924122,9197130620,11808129809,27,16,17,24,14,13
"2334","0000","COUNTY TOTAL",26201494,0,0,NA,"2016"," LA","County Total","22017","Caddo ",0,0,0,0,26201494,109,145.5,142.5,142.5,143.5,143.5
"2335","0000","COUNTY TOTAL",3921982450,51849244,112097674,NA,"2016"," LA","County Total","22019","Calcasieu",30817888,161578670,273676344,82667132,3952800338,35,41,48,34,47,36
"2336","0000","COUNTY TOTAL",365014401,7003775,51570991,NA,"2016"," TX","County Total","48057","Calhoun",134015237,294919689,346490680,141019012,499029638,67,43,63,46,44,35
"2337","0000","COUNTY TOTAL",4754884225,22365164,60341226,NA,"2016"," TX","County Total","22023","Cameron",18485936,104556312,164897538,40851100,4773370161,32,36,49,28,53,43
"2338","0000","COUNTY TOTAL",270293978,2105000,3029283,NA,"2016"," NC","County Total","37031","Carteret",187545537,118614013,121643296,189650537,457839515,79,54,95,79,42,47
"2339","0000","COUNTY TOTAL",4854161202,490034127,536353381,NA,"2016"," TX","County Total","48071","Chambers",97694,73854,536427235,490131821,4854258896,37,40,28,25,82,75
"2340","0000","COUNTY TOTAL",33061344174,14427595777,5752722724,NA,"2016"," SC","County Total","45019","Charleston",41872789603,7062522421,12815245145,56300385380,74934133777,6,6,8,8,4,5
"2341","0000","COUNTY TOTAL",103258,0,0,NA,"2016"," MS","County Total","05017","Chicot",43079,45797,45797,43079,146337,152,120,122,120,114,108
"2342","0000","COUNTY TOTAL",1013869237,211205,23396,NA,"2016"," MI","County Total","26033","Chippewa",0,0,23396,211205,1013869237,62,73,79,96,94,68
"2343","0000","COUNTY TOTAL",65166437,69207,22814,NA,"2016"," WA","County Total","53009","Clallam",261276,34223,57037,330483,65427713,93,116,117,111,107,106
"2344","0000","COUNTY TOTAL",1861627894,41776610,33227036,NA,"2016"," WA","County Total","53011","Clark",78607138,146462860,179689896,120383748,1940235032,53,48,52,38,58,56
"2345","0000","COUNTY TOTAL",37733429,72072,18232,NA,"2016"," OR","County Total","41007","Clatsop",2495780,147933,166165,2567852,40229209,105,105,101,101,86,91
"2346","0000","COUNTY TOTAL",15250754316,0,0,NA,"2016"," GA","County Total","13067","Cobb",0,0,0,0,15250754316,25,145.5,142.5,142.5,143.5,143.5
"2347","0000","COUNTY TOTAL",732200530,50355445,54119949,NA,"2016"," CA","County Total","06013","Contra Costa",2022073,118460,54238409,52377518,734222603,68,59,57,49,45,62
"2348","0000","COUNTY TOTAL",142797119,0,0,NA,"2016"," OR","County Total","41011","Coos",177517,8039,8039,177517,142974636,89,79,104,69,113,81
"2349","0000","COUNTY TOTAL",5742247748,61625167,349717492,NA,"2016"," WA","County Total","53015","Cowlitz",12188403,1524139,351241631,73813570,5754436151,39,46,55,33,59,54
"2350","0000","COUNTY TOTAL",186390555,118434224,32072628,NA,"2016"," ME","County Total","23005","Cumberland",283461733,98100707,130173335,401895957,469852288,70,49,35,50,36,46
"2351","0000","COUNTY TOTAL",28726492356,29134462,9845824,NA,"2016"," OH","County Total","39035","Cuyahoga",156899244,70157287,80003111,186033706,28883391600,16,60,59,64,46,53
"2352","0000","COUNTY TOTAL",187932377,3817076,4021108,NA,"2016"," NJ","County Total","42045","Delaware",0,0,4021108,3817076,187932377,45,27,21,35,21,26
"2353","0000","COUNTY TOTAL",2125337031,1733769244,224560449,NA,"2016"," PA","County Total","42045","Delaware",3441135042,687586505,912146954,5174904286,5566472073,45,27,21,35,21,26
"2354","0000","COUNTY TOTAL",1980241,5750,930,NA,"2016"," MI","County Total","26041","Delta",501857,83882,84812,507607,2482098,140,123,126,129,109,109
"2355","0000","COUNTY TOTAL",50182,0,0,NA,"2016"," MD","County Total","24019","Dorchester",0,0,0,0,50182,120,111,120,122,92,94
"2356","0000","COUNTY TOTAL",363435197,69240,114223,NA,"2016"," WI","County Total","55031","Douglas",62175757,5612860,5727083,62244997,425610954,77,68,84,78,56,61
"2357","0000","COUNTY TOTAL",45482334664,148981370,77829870,NA,"2016"," IL","County Total","17043","DuPage",419591797,241049953,318879823,568573167,45901926461,8,45,39,45,35,38
"2358","0000","COUNTY TOTAL",24552014472,16709940829,10912699532,NA,"2016"," GA","County Total","13103","Effingham",55302129175,11897383500,22810083032,72012070004,79854143647,4,2,6,3,2,2
"2359","0000","COUNTY TOTAL",47173901525,234270665,42005037,NA,"2016"," NY","County Total","36029","Erie",77115000,14634336,56639373,311385665,47251016525,13,63,33,52,55,63
"2360","0000","COUNTY TOTAL",5567573,0,0,NA,"2016"," OH","County Total","39043","Erie",506817,54463,54463,506817,6074390,108,109,142.5,142.5,85,92
"2361","0000","COUNTY TOTAL",89606,0,0,NA,"2016"," PA","County Total","42049","Erie",16112211,2056327,2056327,16112211,16201817,113,94,113,125,73,85
"2362","0000","COUNTY TOTAL",312531,300047,581650,NA,"2016"," MA","County Total","25009","Essex",21181701,3418992,4000642,21481748,21494232,125,90,88,83,75,82
"2363","0000","COUNTY TOTAL",1151767,0,0,NA,"2016"," AK","County Total","02090","Fairbanks North Star",0,0,0,0,1151767,117,121,119,108,143.5,143.5
"2364","0000","COUNTY TOTAL",263401,95425,116598,NA,"2016"," VA","County Total","51059","Fairfax",0,0,116598,95425,263401,107,107,108,92,123,120
"2365","0000","COUNTY TOTAL",7893079,0,0,NA,"2016"," CT","County Total","09001","Fairfield",102106,21338,21338,102106,7995185,134,126,121,116,121,117
"2366","0000","COUNTY TOTAL",163657547,0,0,NA,"2016"," OH","County Total","39045","Fairfield",0,0,0,0,163657547,81,145.5,142.5,142.5,143.5,143.5
"2367","0000","COUNTY TOTAL",146934861,0,0,NA,"2016"," NC","County Total","37067","Forsyth",0,0,0,0,146934861,103,145.5,142.5,142.5,143.5,143.5
"2368","0000","COUNTY TOTAL",1422050806,80098403,110169151,NA,"2016"," TX","County Total","48167","Galveston",482945500,340508487,450677638,563043903,1904996306,49,37,37,41,32,31
"2369","0000","COUNTY TOTAL",527581,315735,80943,NA,"2016"," SC","County Total","45043","Georgetown",4797768,3738084,3819027,5113503,5325349,133,93,97,97,81,86
"2370","0000","COUNTY TOTAL",6005673194,89797939,75565104,NA,"2016"," GA","County Total","13127","Glynn",349792962,26390018,101955122,439590901,6355466156,36,52,32,44,30,52
"2371","0000","COUNTY TOTAL",1770368317,210555661,16316956,NA,"2016"," WA","County Total","53027","Grays Harbor",21200512,2113588,18430544,231756173,1791568829,55,67,40,57,62,70
"2372","0000","COUNTY TOTAL",5096248140,0,0,NA,"2016"," OH","County Total","39061","Hamilton",0,0,0,0,5096248140,41,145.5,142.5,142.5,143.5,143.5
"2373","0000","COUNTY TOTAL",873330,0,0,NA,"2016"," ME","County Total","23009","Hancock",0,0,0,0,873330,145,134,142.5,142.5,119,124
"2374","0000","COUNTY TOTAL",5569460885,23268861,14516498,NA,"2016"," TX","County Total","48199","Hardin",97590142,158109602,172626100,120859003,5667051027,29,39,41,30,50,37
"2375","0000","COUNTY TOTAL",735501457,635132938,438903795,NA,"2016"," MS","County Total","28047","Harrison",1631838921,983160817,1422064612,2266971859,2367340378,51,22,24,21,23,22
"2376","0000","COUNTY TOTAL",350217549,7963,192,NA,"2016"," CT","County Total","09003","Hartford",0,0,192,7963,350217549,83,114,112,115,87,101
"2377","0000","COUNTY TOTAL",207195993,8613346,10501931,NA,"2016"," HI","County Total","15001","Hawaii",62216,25428,10527359,8675562,207258209,88,77,64,60,95,95
"2378","0000","COUNTY TOTAL",1541058703,0,0,NA,"2016"," MN","County Total","27054","Hennepin",0,0,0,0,1541058703,61,145.5,142.5,142.5,143.5,143.5
"2379","0000","COUNTY TOTAL",2006750524,71270673,120676673,NA,"2016"," FL","County Total","12057","Hillsborough",687478009,486582291,607258964,758748682,2694228533,50,32,44,39,25,27
"2380","0000","COUNTY TOTAL",277956051,98329320,125181649,NA,"2016"," HI","County Total","15003","Honolulu",485364192,170932381,296114030,583693512,763320243,69,25,43,37,34,24
"2381","0000","COUNTY TOTAL",243570881,220000,27452,NA,"2016"," AK","County Total","02105","Hoonah-Angoon",35922,5927,33379,255922,243606803,84,103,82,89,108,119
"2382","0000","COUNTY TOTAL",11866536,0,0,NA,"2016"," CA","County Total","06023","Humboldt",1793680,72943,72943,1793680,13660216,116,82,103,66,89,97
"2383","0000","COUNTY TOTAL",3025082965,229427726,400089454,NA,"2016"," MS","County Total","28059","Jackson",81141874,1246216,401335670,310569600,3106224839,48,42,31,26,69,84
"2384","0000","COUNTY TOTAL",92716964,0,0,NA,"2016"," AL","County Total","01073","Jefferson",0,0,0,0,92716964,100,145.5,142.5,142.5,143.5,143.5
"2385","0000","COUNTY TOTAL",6254013986,11962182,1823780,NA,"2016"," NY","County Total","36045","Jefferson",1789113,136124,1959904,13751295,6255803099,34,96,69,82,78,99
"2386","0000","COUNTY TOTAL",44172341,43211579,274511,NA,"2016"," WA","County Total","53031","Jefferson",1764712,37181,311692,44976291,45937053,87,101,38,88,98,111
"2387","0000","COUNTY TOTAL",6455231,0,0,NA,"2016"," MI","County Total","26081","Kent",0,0,0,0,6455231,128,145.5,142.5,142.5,143.5,143.5
"2388","0000","COUNTY TOTAL",73887100,5175968,1847926,NA,"2016"," AK","County Total","02130","Ketchikan Gateway",1252131,256342,2104268,6428099,75139231,99,99,89,90,97,90
"2389","0000","COUNTY TOTAL",6519451095,3903548670,3919195958,NA,"2016"," WA","County Total","53035","Kitsap",14318620893,3422337188,7341533146,18222169563,20838071988,17,10,14,10,11,11
"2390","0000","COUNTY TOTAL",562535,0,0,NA,"2016"," ME","County Total","23013","Knox",9066,6596,6596,9066,571601,149,136,142.5,142.5,130,126
"2391","0000","COUNTY TOTAL",4457658637,124359898,167603445,NA,"2016"," MN","County Total","27071","Koochiching",549878649,126916447,294519892,674238547,5007537286,44,44,42,36,33,42
"2392","0000","COUNTY TOTAL",129479,0,0,NA,"2016"," OR","County Total","41041","Lincoln",0,0,0,0,129479,135,100,83,87,128,128
"2393","0000","COUNTY TOTAL",32727187415,27372053315,13751241400,NA,"2016"," CA","County Total","06037","Los Angeles",218044689760,37512970092,51264211492,245416743075,250771877175,1,1,1,1,1,1
"2394","0000","COUNTY TOTAL",1683054,0,0,NA,"2016"," MS","County Total","22065","Madison",46479,1085,1085,46479,1729533,148,124,142.5,142.5,120,113
"2395","0000","COUNTY TOTAL",107051313,19216523,35077481,NA,"2016"," FL","County Total","12081","Manatee",312400203,363203637,398281118,331616726,419451516,80,35,60,47,38,28
"2396","0000","COUNTY TOTAL",104451,99470,5617,NA,"2016"," WI","County Total","55075","Marinette",10037,3929,9546,109507,114488,144,130,107,119,132,131
"2397","0000","COUNTY TOTAL",66006979,0,0,NA,"2016"," MI","County Total","26103","Marquette",0,0,0,0,66006979,96,125,142.5,142.5,106,114
"2398","0000","COUNTY TOTAL",18121730621,1897098119,742091983,NA,"2016"," AK","County Total","02170","Matanuska-Susitna",44841647,45448691,787540674,1941939766,18166572268,23,33,20,22,61,57
"2399","0000","COUNTY TOTAL",7102148,2665845,2994795,NA,"2016"," HI","County Total","15009","Maui",15717,19026,3013821,2681562,7117865,121,89,76,75,105,105
"2400","0000","COUNTY TOTAL",9501901735,7316688584,2106372483,NA,"2016"," FL","County Total","12086","Miami-Dade",13530867755,3265140791,5371513274,20847556339,23032769490,18,13,10,13,12,12
"2401","0000","COUNTY TOTAL",42060453,3221951,347004,NA,"2016"," FL","County Total","12087","Monroe",1598223,151912,498916,4820174,43658676,106,95,78,80,100,103
"2402","0000","COUNTY TOTAL",13960422,365153,125789,NA,"2016"," NY","County Total","36055","Monroe",3109052,216270,342059,3474205,17069474,123,108,100,100,96,100
"2403","0000","COUNTY TOTAL",1177139,935797,119488,NA,"2016"," CA","County Total","06053","Monterey",0,0,119488,935797,1177139,131,88,80,74,111,116
"2404","0000","COUNTY TOTAL",16015713,0,0,NA,"2016"," OH","County Total","39113","Montgomery",0,0,0,0,16015713,112,145.5,142.5,142.5,143.5,143.5
"2405","0000","COUNTY TOTAL",62983044948,24834153050,11672542728,NA,"2016"," TX","County Total","48339","Montgomery",26857065627,9085592639,20758135367,51691218677,89840110575,2,3,2,2,6,3
"2406","0000","COUNTY TOTAL",1977785146,473224,1077776,NA,"2016"," AL","County Total","01103","Morgan",0,0,1077776,473224,1977785146,56,106,91,91,143.5,143.5
"2407","0000","COUNTY TOTAL",1137666,1084734,111079,NA,"2016"," MI","County Total","26121","Muskegon",0,0,111079,1084734,1137666,146,112,99,107,104,102
"2408","0000","COUNTY TOTAL",6278636457,3013470772,1074093771,NA,"2016"," FL","County Total","12089","Nassau",5297215630,3769740797,4843834568,8310686402,11575852087,28,17,16,17,16,17
"2409","0000","COUNTY TOTAL",4273009967,3533870837,936398026,NA,"2016"," NC","County Total","37129","New Hanover",3508962307,919414495,1855812521,7042833144,7781972274,31,19,15,16,20,21
"2410","0000","COUNTY TOTAL",43597361,44000,61195,NA,"2016"," CT","County Total","09009","New Haven",18536467,16002321,16063516,18580467,62133828,97,62,85,70,67,55
"2411","0000","COUNTY TOTAL",387057,290849,24119,NA,"2016"," CT","County Total","09011","New London",1746001,3587292,3611411,2036850,2133058,118,83,102,104,80,73
"2412","0000","COUNTY TOTAL",86590,34684,650,NA,"2016"," MA","County Total","44005","Newport",487139,170141,170791,521823,573729,115,104,92,103,93,89
"2413","0000","COUNTY TOTAL",8265593,49804,2973,NA,"2016"," RI","County Total","44005","Newport",85266,14534,17507,135070,8350859,115,104,92,103,93,89
"2414","0000","COUNTY TOTAL",1100351637,746927530,704225641,NA,"2016"," MA","County Total","25021","Norfolk",3936483274,990097582,1694323223,4683410804,5036834911,42,21,22,20,19,20
"2415","0000","COUNTY TOTAL",73250513583,102588350,26884904,NA,"2016"," MI","County Total","26125","Oakland",60163009,69261387,96146291,162751359,73310676592,5,55,36,48,48,49
"2416","0000","COUNTY TOTAL",55225768,0,0,NA,"2016"," NY","County Total","36067","Onondaga",0,0,0,0,55225768,101,145.5,142.5,142.5,143.5,143.5
"2417","0000","COUNTY TOTAL",32420163662,26544168090,12369497288,NA,"2016"," CA","County Total","06059","Orange",51044094578,9344834334,21714331622,77588262668,83464258240,3,4,4,4,3,4
"2418","0000","COUNTY TOTAL",60642,44067,20283,NA,"2016"," TX","County Total","48361","Orange",0,0,20283,44067,60642,110,98,74,85,118,122
"2419","0000","COUNTY TOTAL",57817910437,4925778211,3490178381,NA,"2016"," LA","County Total","22071","Orleans",4440151574,2871732619,6361911000,9365929785,62258062011,7,12,13,11,17,15
"2420","0000","COUNTY TOTAL",2295522116,0,0,NA,"2016"," FL","County Total","12097","Osceola",0,0,0,0,2295522116,60,145.5,142.5,142.5,143.5,143.5
"2421","0000","COUNTY TOTAL",908361,0,0,NA,"2016"," NY","County Total","36075","Oswego",3471099,8367912,8367912,3471099,4379460,119,70,106,124,70,65
"2422","0000","COUNTY TOTAL",1810263244,1372989178,511771269,NA,"2016"," FL","County Total","12099","Palm Beach",226683059,104862093,616633362,1599672237,2036946303,54,29,19,23,39,41
"2423","0000","COUNTY TOTAL",1262776650,497610,490804,NA,"2016"," ME","County Total","23019","Penobscot",34512,9609,500413,532122,1262811162,65,84,93,99,88,76
"2424","0000","COUNTY TOTAL",1265545,0,0,NA,"2016"," IL","County Total","17143","Peoria",891815,144439,144439,891815,2157360,129,110,130,114,79,96
"2425","0000","COUNTY TOTAL",129361521,57909300,5380626,NA,"2016"," NJ","County Total","42101","Philadelphia",2113719,3034713,8415339,60023019,131475240,94,76,56,76,74,71
"2426","0000","COUNTY TOTAL",10773146842,7852286878,6423495695,NA,"2016"," WA","County Total","53053","Pierce",38636193046,5622023655,12045519350,46488479924,49409339888,12,9,11,9,5,8
"2427","0000","COUNTY TOTAL",1881994,1205643,1715863,NA,"2016"," MA","County Total","25023","Plymouth",1893624,1294955,3010818,3099267,3775618,147,102,109,94,103,93
"2428","0000","COUNTY TOTAL",9283537,0,0,NA,"2016"," IN","County Total","18127","Porter",145655,42408,42408,145655,9429192,136,119,114,118,116,110
"2429","0000","COUNTY TOTAL",172592435,8700,3979,NA,"2016"," RI","County Total","44007","Providence",77473345,324367700,324371679,77482045,250065780,73,51,70,62,37,44
"2430","0000","COUNTY TOTAL",497328,141820,14440,NA,"2016"," WI","County Total","55101","Racine",84786,58127,72567,226606,582114,141,113,94,110,115,104
"2431","0000","COUNTY TOTAL",2884685,0,0,NA,"2016"," SC","County Total","45079","Richland",0,0,0,0,2884685,142,145.5,142.5,142.5,143.5,143.5
"2432","0000","COUNTY TOTAL",420815229,141849597,6681739,NA,"2016"," NH","County Total","33015","Rockingham",28560443,2826412,9508151,170410040,449375672,75,57,54,58,63,50
"2433","0000","COUNTY TOTAL",3058762128,882633428,282214057,NA,"2016"," DE","County Total","34033","Salem",806239721,1336815216,1619029273,1688873149,3865001849,46,20,23,29,26,18
"2434","0000","COUNTY TOTAL",1962260002,61928740,17191620,NA,"2016"," CA","County Total","06073","San Diego",488349031,658982617,676174237,550277771,2450609033,58,28,45,54,28,23
"2435","0000","COUNTY TOTAL",318289085,75130,13717,NA,"2016"," CA","County Total","06077","San Joaquin",127338856,187228108,187241825,127413986,445627941,78,50,71,67,54,40
"2436","0000","COUNTY TOTAL",763584,0,0,NA,"2016"," WA","County Total","53055","San Juan",0,0,0,0,763584,127,127,124,121,117,115
"2437","0000","COUNTY TOTAL",506778,69934,8530,NA,"2016"," CA","County Total","06079","San Luis Obispo",431900,16101,24631,501834,938678,138,118,116,113,110,112
"2438","0000","COUNTY TOTAL",723356150,49882839,7944748,NA,"2016"," CA","County Total","06081","San Mateo",617213191,161824928,169769676,667096030,1340569341,47,38,46,55,22,30
"2439","0000","COUNTY TOTAL",9793957848,234375762,593723293,NA,"2016"," TX","County Total","48409","San Patricio",448492513,313440288,907163581,682868275,10242450361,20,24,27,18,40,39
"2440","0000","COUNTY TOTAL",38382484,384124,169633,NA,"2016"," FL","County Total","12113","Santa Rosa",0,0,169633,384124,38382484,90,80,75,72,71,78
"2441","0000","COUNTY TOTAL",866488615,315464,70196,NA,"2016"," WA","County Total","53057","Skagit",54134,25880,96076,369598,866542749,66,74,68,61,90,88
"2442","0000","COUNTY TOTAL",150441994,0,0,NA,"2016"," AK","County Total","02230","Skagway",0,0,0,0,150441994,85,129,123,117,124,123
"2443","0000","COUNTY TOTAL",27358321063,9260763,6508870,NA,"2016"," WA","County Total","53061","Snohomish",1367188775,12403652,18912522,1376449538,28725509838,22,61,51,53,24,60
"2444","0000","COUNTY TOTAL",42510143996,585947289,85532037,NA,"2016"," MI","County Total","26147","St. Clair",130882839,24814940,110346977,716830128,42641026835,11,53,26,42,49,58
"2445","0000","COUNTY TOTAL",12262410214,115222921,299443378,NA,"2016"," LA","County Total","22093","St. James",56037040,76181710,375625088,171259961,12318447254,26,34,50,32,52,32
"2446","0000","COUNTY TOTAL",619125220,128374,99909,NA,"2016"," NY","County Total","36089","St. Lawrence",15175624,2594715,2694624,15303998,634300844,71,97,110,106,83,87
"2447","0000","COUNTY TOTAL",7968854,152157,26566,NA,"2016"," FL","County Total","12111","St. Lucie",610852,2078976,2105542,763009,8579706,111,86,87,93,102,77
"2448","0000","COUNTY TOTAL",479677132,29408585,8335003,NA,"2016"," LA","County Total","22101","St. Mary",26998878,3425155,11760158,56407463,506676010,52,65,58,59,51,64
"2449","0000","COUNTY TOTAL",115547264,2269788,12143964,NA,"2016"," WA","County Total","53067","Thurston",236500,65404,12209368,2506288,115783764,95,85,86,71,112,118
"2450","0000","COUNTY TOTAL",1243904577,287787764,79914205,NA,"2016"," CA","County Total","06111","Ventura",457515787,430478219,510392424,745303551,1701420364,57,30,30,40,27,25
"2451","0000","COUNTY TOTAL",5773858,1668361,572529,NA,"2016"," VA","County Total","51812","Virginia Beach",15444274,1461297,2033826,17112635,21218132,19,15,72,65,8.5,9.5
"2452","0000","COUNTY TOTAL",5773858,1668361,572529,NA,"2016"," VA","County Total","51812","Virginia Beach",42331571367,8901737241,8902309770,42333239728,42337345225,19,15,72,65,8.5,9.5
"2453","0000","COUNTY TOTAL",25985867136,18770167581,7644441594,NA,"2016"," VA","County Total","51811","Virginia Beach",15444274,1461297,7645902891,18785611855,26001311410,9,7,5,6,8.5,9.5
"2454","0000","COUNTY TOTAL",25985867136,18770167581,7644441594,NA,"2016"," VA","County Total","51811","Virginia Beach",42331571367,8901737241,16546178835,61101738948,68317438503,9,7,5,6,8.5,9.5
"2455","0000","COUNTY TOTAL",397725,0,0,NA,"2016"," WV","County Total","51813","Virginia Beach",0,0,0,0,397725,151,145.5,142.5,142.5,143.5,143.5
"2456","0000","COUNTY TOTAL",341218111,0,0,NA,"2016"," NC","County Total","37183","Wake",0,0,0,0,341218111,82,145.5,142.5,142.5,143.5,143.5
"2457","0000","COUNTY TOTAL",14255394,269010,270089,NA,"2016"," ME","County Total","23027","Waldo",79264234,10533017,10803106,79533244,93519628,104,72,105,98,65,67
"2458","0000","COUNTY TOTAL",6576,0,0,NA,"2016"," VA","County Total","51187","Warren",0,0,0,0,6576,153,145.5,142.5,142.5,143.5,143.5
"2459","0000","COUNTY TOTAL",1409804422,778213,229423,NA,"2016"," ME","County Total","23029","Washington",412528,187736,417159,1190741,1410216950,59,66,62,51,101,98
"2460","0000","COUNTY TOTAL",3882117526,78513769,257908341,NA,"2016"," OR","County Total","41067","Washington",10844960,2294284,260202625,89358729,3892962486,43,26,29,27,29,33
"2461","0000","COUNTY TOTAL",155987474,11006964,458967,NA,"2016"," WI","County Total","55133","Waukesha",6138322,2745300,3204267,17145286,162125796,91,75,65,86,72,69
"2462","0000","COUNTY TOTAL",580159,0,0,NA,"2016"," NY","County Total","36117","Wayne",10014,1067,1067,10014,590173,137,131,142.5,142.5,122,121
"2463","0000","COUNTY TOTAL",5477205586,58561081,398719771,NA,"2016"," LA","County Total","22121","West Baton Rouge",69282930,378450844,777170615,127844011,5546488516,33,31,53,31,43,29
"2464","0000","COUNTY TOTAL",17317234874,108619430,33592974,NA,"2016"," WA","County Total","53073","Whatcom",7604280,1110051,34703025,116223710,17324839154,24,69,47,56,68,80
"2465","0000","COUNTY TOTAL",492181727,996164,440842,NA,"2016"," OH","County Total","39173","Wood",32629585,17788105,18228947,33625749,524811312,74,64,81,68,64,59
"2466","0000","COUNTY TOTAL",1445321,1018629,236895,NA,"2016"," MA","County Total","25027","Worcester",0,0,236895,1018629,1445321,102,115,96,102,143.5,143.5
"2467","0000","COUNTY TOTAL",8921101,8711622,4268509,NA,"2016"," AK","County Total","02275","Wrangell",0,0,4268509,8711622,8921101,132,87,67,73,125,130
"2468","0000","COUNTY TOTAL",613995957,0,0,NA,"2016"," NC","County Total","45091","York",0,0,0,0,613995957,72,145.5,142.5,142.5,143.5,143.5
"2469","0000","COUNTY TOTAL",21147785112,16000091332,7761246509,NA,"2017"," CA","County Total","06001","Alameda",26357485310,6858240041,14619486550,42357576642,47505270422,10,5,7,7,7,6
"2470","0000","COUNTY TOTAL",275877022,9619609,810489,NA,"2017"," NY","County Total","36001","Albany",99635113,140992535,141803024,109254722,375512135,76,56,61,77,57,48
"2471","0000","COUNTY TOTAL",166647998,0,0,NA,"2017"," PA","County Total","42003","Allegheny",0,0,0,0,166647998,98,145.5,142.5,142.5,143.5,143.5
"2472","0000","COUNTY TOTAL",5791944,45290,2188,NA,"2017"," MI","County Total","26007","Alpena",0,0,2188,45290,5791944,126,135,127,130,129,125
"2473","0000","COUNTY TOTAL",22707274,12072096,2537281,NA,"2017"," MD","County Total","24003","Anne Arundel",5089402,2157647,4694928,17161498,27796676,114,91,73,81,76,83
"2474","0000","COUNTY TOTAL",5845962300,893267,147140,NA,"2017"," DC","County Total","51013","Arlington",31647810,8017992,8165132,32541077,5877610110,40,81,77,84,66,74
"2475","0000","COUNTY TOTAL",1117127159,0,0,NA,"2017"," ME","County Total","23003","Aroostook",0,0,0,0,1117127159,64,145.5,142.5,142.5,143.5,143.5
"2476","0000","COUNTY TOTAL",4585145070,2122719574,1604641491,NA,"2017"," AL","County Total","01003","Baldwin",4130817786,1454020465,3058661956,6253537360,8715962856,30,18,18,15,18,19
"2477","0000","COUNTY TOTAL",15863383108,5996752789,2282132191,NA,"2017"," MD","County Total","24005","Baltimore",17110705736,5128397125,7410529316,23107458525,32974088844,15,11,12,12,10,7
"2478","0000","COUNTY TOTAL",647692812,342313781,76389584,NA,"2017"," FL","County Total","12005","Bay",452011281,100191137,176580721,794325062,1099704093,63,47,34,43,31,45
"2479","0000","COUNTY TOTAL",5568180129,890176754,1272946817,NA,"2017"," TX","County Total","48039","Brazoria",220140729,257841733,1530788550,1110317483,5788320858,38,23,25,19,41,34
"2480","0000","COUNTY TOTAL",68641061,22279245,30056554,NA,"2017"," FL","County Total","12009","Brevard",57474929,67634502,97691056,79754174,126115990,92,58,66,63,60,51
"2481","0000","COUNTY TOTAL",12612284,663079,91726,NA,"2017"," MA","County Total","25005","Bristol",3367023,2288222,2379948,4030102,15979307,124,92,98,105,77,79
"2482","0000","COUNTY TOTAL",32136561087,27199625983,8707627431,NA,"2017"," NY","County Total","36005","Bronx",8539132522,2272021479,10979648910,35738758505,40675693609,14,8,3,5,13,16
"2483","0000","COUNTY TOTAL",12101687169,9861552003,1945513346,NA,"2017"," FL","County Total","12011","Broward",9063629429,3125422701,5070936047,18925181432,21165316598,21,14,9,14,15,14
"2484","0000","COUNTY TOTAL",220577558,1418640,53524,NA,"2017"," WI","County Total","55009","Brown",120508,10021,63545,1539148,220698066,86,71,90,95,84,66
"2485","0000","COUNTY TOTAL",5283100948,2398772864,577350257,NA,"2017"," PA","County Total","42017","Bucks",8583882452,3208772405,3786122662,10982655316,13866983400,27,16,17,24,14,13
"2486","0000","COUNTY TOTAL",39063499,0,0,NA,"2017"," LA","County Total","22017","Caddo ",0,0,0,0,39063499,109,145.5,142.5,142.5,143.5,143.5
"2487","0000","COUNTY TOTAL",6643271997,37162363,127951759,NA,"2017"," LA","County Total","22019","Calcasieu",105711015,527987090,655938849,142873378,6748983012,35,41,48,34,47,36
"2488","0000","COUNTY TOTAL",659176696,16202088,42026470,NA,"2017"," TX","County Total","48057","Calhoun",124292111,271211602,313238072,140494199,783468807,67,43,63,46,44,35
"2489","0000","COUNTY TOTAL",5678579254,25529315,48366907,NA,"2017"," TX","County Total","22023","Cameron",81661201,6277282,54644189,107190516,5760240455,32,36,49,28,53,43
"2490","0000","COUNTY TOTAL",259399881,319319,285424,NA,"2017"," NC","County Total","37031","Carteret",127134624,74154852,74440276,127453943,386534505,79,54,95,79,42,47
"2491","0000","COUNTY TOTAL",5174100616,490011702,487686022,NA,"2017"," TX","County Total","48071","Chambers",137150,23424,487709446,490148852,5174237766,37,40,28,25,82,75
"2492","0000","COUNTY TOTAL",30920912949,15595715217,6607850886,NA,"2017"," SC","County Total","45019","Charleston",42203518858,8283483910,14891334796,57799234075,73124431807,6,6,8,8,4,5
"2493","0000","COUNTY TOTAL",141061,18562,22453,NA,"2017"," MS","County Total","05017","Chicot",28040,25400,47853,46602,169101,152,120,122,120,114,108
"2494","0000","COUNTY TOTAL",1233589951,1108639,74994,NA,"2017"," MI","County Total","26033","Chippewa",374252,24787215,24862209,1482891,1233964203,62,73,79,96,94,68
"2495","0000","COUNTY TOTAL",104378526,0,0,NA,"2017"," WA","County Total","53009","Clallam",39850,11909,11909,39850,104418376,93,116,117,111,107,106
"2496","0000","COUNTY TOTAL",1984173798,14992258,6578193,NA,"2017"," WA","County Total","53011","Clark",28139322,55224746,61802939,43131580,2012313120,53,48,52,38,58,56
"2497","0000","COUNTY TOTAL",47934723,0,0,NA,"2017"," OR","County Total","41007","Clatsop",367897,43775,43775,367897,48302620,105,105,101,101,86,91
"2498","0000","COUNTY TOTAL",16733551702,0,0,NA,"2017"," GA","County Total","13067","Cobb",0,0,0,0,16733551702,25,145.5,142.5,142.5,143.5,143.5
"2499","0000","COUNTY TOTAL",856192383,40675733,62591217,NA,"2017"," CA","County Total","06013","Contra Costa",1826046,346193,62937410,42501779,858018429,68,59,57,49,45,62
"2500","0000","COUNTY TOTAL",137350884,0,0,NA,"2017"," OR","County Total","41011","Coos",1196348,16772188,16772188,1196348,138547232,89,79,104,69,113,81
"2501","0000","COUNTY TOTAL",6008290482,55608530,295519151,NA,"2017"," WA","County Total","53015","Cowlitz",23246528,22480669,317999820,78855058,6031537010,39,46,55,33,59,54
"2502","0000","COUNTY TOTAL",266372675,162483406,35132893,NA,"2017"," ME","County Total","23005","Cumberland",339681403,126237666,161370559,502164809,606054078,70,49,35,50,36,46
"2503","0000","COUNTY TOTAL",32888309718,12527261,4433003,NA,"2017"," OH","County Total","39035","Cuyahoga",247045354,25556556,29989559,259572615,33135355072,16,60,59,64,46,53
"2504","0000","COUNTY TOTAL",32863187,114151,179842,NA,"2017"," NJ","County Total","42045","Delaware",109362,14167,194009,223513,32972549,45,27,21,35,21,26
"2505","0000","COUNTY TOTAL",2204832853,1900025045,225309273,NA,"2017"," PA","County Total","42045","Delaware",3931986055,810221836,1035531109,5832011100,6136818908,45,27,21,35,21,26
"2506","0000","COUNTY TOTAL",1141950,0,0,NA,"2017"," MI","County Total","26041","Delta",229913,15792,15792,229913,1371863,140,123,126,129,109,109
"2507","0000","COUNTY TOTAL",101351,0,0,NA,"2017"," MD","County Total","24019","Dorchester",18033,2606,2606,18033,119384,120,111,120,122,92,94
"2508","0000","COUNTY TOTAL",453708126,3484473,12758340,NA,"2017"," WI","County Total","55031","Douglas",69198863,14247000,27005340,72683336,522906989,77,68,84,78,56,61
"2509","0000","COUNTY TOTAL",47829897517,141179465,40140764,NA,"2017"," IL","County Total","17043","DuPage",540894116,164646892,204787656,682073581,48370791633,8,45,39,45,35,38
"2510","0000","COUNTY TOTAL",26393953393,20141175281,1.2289e+10,NA,"2017"," GA","County Total","13103","Effingham",59732626330,12796477055,25085477994,79873801611,86126579723,4,2,6,3,2,2
"2511","0000","COUNTY TOTAL",42335080820,164639725,19248594,NA,"2017"," NY","County Total","36029","Erie",56717304,11712371,30960965,221357029,42391798124,13,63,33,52,55,63
"2512","0000","COUNTY TOTAL",5512566,0,0,NA,"2017"," OH","County Total","39043","Erie",243895,18373,18373,243895,5756461,108,109,142.5,142.5,85,92
"2513","0000","COUNTY TOTAL",4980811,0,0,NA,"2017"," PA","County Total","42049","Erie",4081534,530006,530006,4081534,9062345,113,94,113,125,73,85
"2514","0000","COUNTY TOTAL",1415596,894854,470894,NA,"2017"," MA","County Total","25009","Essex",1380715,61167,532061,2275569,2796311,125,90,88,83,75,82
"2515","0000","COUNTY TOTAL",1994137,0,0,NA,"2017"," AK","County Total","02090","Fairbanks North Star",0,0,0,0,1994137,117,121,119,108,143.5,143.5
"2516","0000","COUNTY TOTAL",39642383,180764,427444,NA,"2017"," VA","County Total","51059","Fairfax",245009,93943,521387,425773,39887392,107,107,108,92,123,120
"2517","0000","COUNTY TOTAL",14375254,24198,20026,NA,"2017"," CT","County Total","09001","Fairfield",33462,11846,31872,57660,14408716,134,126,121,116,121,117
"2518","0000","COUNTY TOTAL",531548465,0,0,NA,"2017"," OH","County Total","39045","Fairfield",0,0,0,0,531548465,81,145.5,142.5,142.5,143.5,143.5
"2519","0000","COUNTY TOTAL",11873278,0,0,NA,"2017"," NC","County Total","37067","Forsyth",0,0,0,0,11873278,103,145.5,142.5,142.5,143.5,143.5
"2520","0000","COUNTY TOTAL",1601353164,125346403,86275757,NA,"2017"," TX","County Total","48167","Galveston",457018738,316961824,403237581,582365141,2058371902,49,37,37,41,32,31
"2521","0000","COUNTY TOTAL",729714,150540,83741,NA,"2017"," SC","County Total","45043","Georgetown",3233401,514336,598077,3383941,3963115,133,93,97,97,81,86
"2522","0000","COUNTY TOTAL",6021334986,306095074,46889526,NA,"2017"," GA","County Total","13127","Glynn",319588702,24641710,71531236,625683776,6340923688,36,52,32,44,30,52
"2523","0000","COUNTY TOTAL",1642030202,327585453,25089802,NA,"2017"," WA","County Total","53027","Grays Harbor",198437959,16898482,41988284,526023412,1840468161,55,67,40,57,62,70
"2524","0000","COUNTY TOTAL",5271200229,0,0,NA,"2017"," OH","County Total","39061","Hamilton",0,0,0,0,5271200229,41,145.5,142.5,142.5,143.5,143.5
"2525","0000","COUNTY TOTAL",11123310891,15566493,10371253,NA,"2017"," TX","County Total","48199","Hardin",50601906,136596254,146967507,66168399,11173912797,29,39,41,30,50,37
"2526","0000","COUNTY TOTAL",1025263359,922975228,683185243,NA,"2017"," MS","County Total","28047","Harrison",1632015171,889997536,1573182779,2554990399,2657278530,51,22,24,21,23,22
"2527","0000","COUNTY TOTAL",273288876,44513,2472,NA,"2017"," CT","County Total","09003","Hartford",82882,28181,30653,127395,273371758,83,114,112,115,87,101
"2528","0000","COUNTY TOTAL",252516413,12889754,17598335,NA,"2017"," HI","County Total","15001","Hawaii",278923,72650,17670985,13168677,252795336,88,77,64,60,95,95
"2529","0000","COUNTY TOTAL",1434385585,0,0,NA,"2017"," MN","County Total","27054","Hennepin",0,0,0,0,1434385585,61,145.5,142.5,142.5,143.5,143.5
"2530","0000","COUNTY TOTAL",2007531408,84425009,132377371,NA,"2017"," FL","County Total","12057","Hillsborough",803836314,410804634,543182005,888261323,2811367722,50,32,44,39,25,27
"2531","0000","COUNTY TOTAL",377824124,99489660,135724561,NA,"2017"," HI","County Total","15003","Honolulu",519424271,924757697,1060482258,618913931,897248395,69,25,43,37,34,24
"2532","0000","COUNTY TOTAL",142014565,483949,9,NA,"2017"," AK","County Total","02105","Hoonah-Angoon",6884,2,11,490833,142021449,84,103,82,89,108,119
"2533","0000","COUNTY TOTAL",18586209,2597271,45795087,NA,"2017"," CA","County Total","06023","Humboldt",824865,73355,45868442,3422136,19411074,116,82,103,66,89,97
"2534","0000","COUNTY TOTAL",3011662484,381657825,540837240,NA,"2017"," MS","County Total","28059","Jackson",590618,181540,541018780,382248443,3012253102,48,42,31,26,69,84
"2535","0000","COUNTY TOTAL",229382903,0,0,NA,"2017"," AL","County Total","01073","Jefferson",0,0,0,0,229382903,100,145.5,142.5,142.5,143.5,143.5
"2536","0000","COUNTY TOTAL",6318050336,3250990,754605,NA,"2017"," NY","County Total","36045","Jefferson",486373,29405,784010,3737363,6318536709,34,96,69,82,78,99
"2537","0000","COUNTY TOTAL",1468040,0,0,NA,"2017"," WA","County Total","53031","Jefferson",1369345,29396,29396,1369345,2837385,87,101,38,88,98,111
"2538","0000","COUNTY TOTAL",10131312,0,0,NA,"2017"," MI","County Total","26081","Kent",0,0,0,0,10131312,128,145.5,142.5,142.5,143.5,143.5
"2539","0000","COUNTY TOTAL",45010003,908518,313138,NA,"2017"," AK","County Total","02130","Ketchikan Gateway",433939,99460,412598,1342457,45443942,99,99,89,90,97,90
"2540","0000","COUNTY TOTAL",8263384633,5070936700,4593097592,NA,"2017"," WA","County Total","53035","Kitsap",17232920388,4249441749,8842539341,22303857088,25496305021,17,10,14,10,11,11
"2541","0000","COUNTY TOTAL",4520600346,87882736,83880902,NA,"2017"," MN","County Total","27071","Koochiching",526082229,121634151,205515053,613964965,5046682575,44,44,42,36,33,42
"2542","0000","COUNTY TOTAL",29180,0,0,NA,"2017"," OR","County Total","41041","Lincoln",0,0,0,0,29180,135,100,83,87,128,128
"2543","0000","COUNTY TOTAL",29614614,40528,21546,NA,"2017"," OH","County Total","39093","Lorain",8153,413,21959,48681,29622767,122,117,125,127,99,107
"2544","0000","COUNTY TOTAL",35496551629,31372079858,16144648125,NA,"2017"," CA","County Total","06037","Los Angeles",224901223859,38217547248,54362195373,256273303717,260397775488,1,1,1,1,1,1
"2545","0000","COUNTY TOTAL",259190,0,0,NA,"2017"," MS","County Total","22065","Madison",0,0,0,0,259190,148,124,142.5,142.5,120,113
"2546","0000","COUNTY TOTAL",97808703,26554095,42406804,NA,"2017"," FL","County Total","12081","Manatee",255105570,343015200,385422004,281659665,352914273,80,35,60,47,38,28
"2547","0000","COUNTY TOTAL",202566,185340,2304,NA,"2017"," WI","County Total","55075","Marinette",0,0,2304,185340,202566,144,130,107,119,132,131
"2548","0000","COUNTY TOTAL",94058030,0,0,NA,"2017"," MI","County Total","26103","Marquette",44928,11404,11404,44928,94102958,96,125,142.5,142.5,106,114
"2549","0000","COUNTY TOTAL",19366125882,1272901724,458001042,NA,"2017"," AK","County Total","02170","Matanuska-Susitna",35076577,42285856,500286898,1307978301,19401202459,23,33,20,22,61,57
"2550","0000","COUNTY TOTAL",3727951,3006566,4339953,NA,"2017"," HI","County Total","15009","Maui",0,0,4339953,3006566,3727951,121,89,76,75,105,105
"2551","0000","COUNTY TOTAL",9469028135,7661473677,2250119388,NA,"2017"," FL","County Total","12086","Miami-Dade",13714843871,3350173538,5600292926,21376317548,23183872006,18,13,10,13,12,12
"2552","0000","COUNTY TOTAL",21575661,427707,181139,NA,"2017"," FL","County Total","12087","Monroe",201766,42650,223789,629473,21777427,106,95,78,80,100,103
"2553","0000","COUNTY TOTAL",13802086,434921,206256,NA,"2017"," NY","County Total","36055","Monroe",67260,3089,209345,502181,13869346,123,108,100,100,96,100
"2554","0000","COUNTY TOTAL",332953,231223,163951,NA,"2017"," CA","County Total","06053","Monterey",1005268,42041,205992,1236491,1338221,131,88,80,74,111,116
"2555","0000","COUNTY TOTAL",15366045,0,0,NA,"2017"," OH","County Total","39113","Montgomery",0,0,0,0,15366045,112,145.5,142.5,142.5,143.5,143.5
"2556","0000","COUNTY TOTAL",71779370038,27453897124,13249170373,NA,"2017"," TX","County Total","48339","Montgomery",31346580376,10857373483,24106543856,58800477500,1.03126e+11,2,3,2,2,6,3
"2557","0000","COUNTY TOTAL",1762879956,469002,501640,NA,"2017"," AL","County Total","01103","Morgan",0,0,501640,469002,1762879956,56,106,91,91,143.5,143.5
"2558","0000","COUNTY TOTAL",6220470034,3345739744,1160190738,NA,"2017"," FL","County Total","12089","Nassau",7066465277,2693655860,3853846598,10412205021,13286935311,28,17,16,17,16,17
"2559","0000","COUNTY TOTAL",4459870141,3780776851,1115230769,NA,"2017"," NC","County Total","37129","New Hanover",2696832959,703037743,1818268512,6477609810,7156703100,31,19,15,16,20,21
"2560","0000","COUNTY TOTAL",71786924,10251805,36994653,NA,"2017"," CT","County Total","09009","New Haven",11931491,23205500,60200153,22183296,83718415,97,62,85,70,67,55
"2561","0000","COUNTY TOTAL",24000,24000,48000,NA,"2017"," CT","County Total","09011","New London",4382830,4502531,4550531,4406830,4406830,118,83,102,104,80,73
"2562","0000","COUNTY TOTAL",103890,5416,36,NA,"2017"," MA","County Total","44005","Newport",1288924,334463,334499,1294340,1392814,115,104,92,103,93,89
"2563","0000","COUNTY TOTAL",39425174,4993685,115493,NA,"2017"," RI","County Total","44005","Newport",49126,6493,121986,5042811,39474300,115,104,92,103,93,89
"2564","0000","COUNTY TOTAL",1558383552,930560696,838785639,NA,"2017"," MA","County Total","25021","Norfolk",4142927199,1060404336,1899189975,5073487895,5701310751,42,21,22,20,19,20
"2565","0000","COUNTY TOTAL",78306028883,124756500,40010948,NA,"2017"," MI","County Total","26125","Oakland",91949326,17204194,57215142,216705826,78397978209,5,55,36,48,48,49
"2566","0000","COUNTY TOTAL",113072899,0,0,NA,"2017"," NY","County Total","36067","Onondaga",0,0,0,0,113072899,101,145.5,142.5,142.5,143.5,143.5
"2567","0000","COUNTY TOTAL",33798992658,28281655276,11952314132,NA,"2017"," CA","County Total","06059","Orange",58532136755,10637325411,22589639543,86813792031,92331129413,3,4,4,4,3,4
"2568","0000","COUNTY TOTAL",90431,90431,30953,NA,"2017"," TX","County Total","48361","Orange",0,0,30953,90431,90431,110,98,74,85,118,122
"2569","0000","COUNTY TOTAL",62210253318,5780473025,3698308978,NA,"2017"," LA","County Total","22071","Orleans",4860467531,2669004616,6367313594,10640940556,67070720849,7,12,13,11,17,15
"2570","0000","COUNTY TOTAL",1756343276,0,0,NA,"2017"," FL","County Total","12097","Osceola",0,0,0,0,1756343276,60,145.5,142.5,142.5,143.5,143.5
"2571","0000","COUNTY TOTAL",1253133,0,0,NA,"2017"," NY","County Total","36075","Oswego",475017,7062300,7062300,475017,1728150,119,70,106,124,70,65
"2572","0000","COUNTY TOTAL",81607,46392,843,NA,"2017"," MI","County Total","26139","Ottawa",0,0,843,46392,81607,139,132,118,123,131,132
"2573","0000","COUNTY TOTAL",1775795133,1505322468,553666684,NA,"2017"," FL","County Total","12099","Palm Beach",243974563,112115005,665781689,1749297031,2019769696,54,29,19,23,39,41
"2574","0000","COUNTY TOTAL",927639188,724532,26449,NA,"2017"," ME","County Total","23019","Penobscot",0,0,26449,724532,927639188,65,84,93,99,88,76
"2575","0000","COUNTY TOTAL",13220644,0,0,NA,"2017"," IL","County Total","17143","Peoria",18457228,107122,107122,18457228,31677872,129,110,130,114,79,96
"2576","0000","COUNTY TOTAL",26588859,10211523,1065722,NA,"2017"," NJ","County Total","42101","Philadelphia",2139462,290567,1356289,12350985,28728321,94,76,56,76,74,71
"2577","0000","COUNTY TOTAL",9717812522,7331750803,5989285255,NA,"2017"," WA","County Total","53053","Pierce",35507243215,4651227973,10640513228,42838994018,45225055737,12,9,11,9,5,8
"2578","0000","COUNTY TOTAL",309424,296266,444816,NA,"2017"," MA","County Total","25023","Plymouth",0,0,444816,296266,309424,147,102,109,94,103,93
"2579","0000","COUNTY TOTAL",14443081,167505,4983,NA,"2017"," IN","County Total","18127","Porter",0,0,4983,167505,14443081,136,119,114,118,116,110
"2580","0000","COUNTY TOTAL",225637061,12465783,39088214,NA,"2017"," RI","County Total","44007","Providence",72560896,278112089,317200303,85026679,298197957,73,51,70,62,37,44
"2581","0000","COUNTY TOTAL",389708,0,0,NA,"2017"," WI","County Total","55101","Racine",0,0,0,0,389708,141,113,94,110,115,104
"2582","0000","COUNTY TOTAL",167491,0,0,NA,"2017"," SC","County Total","45079","Richland",0,0,0,0,167491,142,145.5,142.5,142.5,143.5,143.5
"2583","0000","COUNTY TOTAL",995902450,114433457,9222448,NA,"2017"," NH","County Total","33015","Rockingham",37684638,64984984,74207432,152118095,1033587088,75,57,54,58,63,50
"2584","0000","COUNTY TOTAL",3104766083,1015613295,360236262,NA,"2017"," DE","County Total","34033","Salem",749415363,1167106964,1527343226,1765028658,3854181446,46,20,23,29,26,18
"2585","0000","COUNTY TOTAL",789898095,101825514,25770448,NA,"2017"," CA","County Total","06073","San Diego",423382278,628482434,654252882,525207792,1213280373,58,28,45,54,28,23
"2586","0000","COUNTY TOTAL",339555009,11234132,30569919,NA,"2017"," CA","County Total","06077","San Joaquin",58043512,87521962,118091881,69277644,397598521,78,50,71,67,54,40
"2587","0000","COUNTY TOTAL",587314,0,0,NA,"2017"," WA","County Total","53055","San Juan",0,0,0,0,587314,127,127,124,121,117,115
"2588","0000","COUNTY TOTAL",1148178,9767,382,NA,"2017"," CA","County Total","06079","San Luis Obispo",134456,26552,26934,144223,1282634,138,118,116,113,110,112
"2589","0000","COUNTY TOTAL",2189290744,88753069,8354349,NA,"2017"," CA","County Total","06081","San Mateo",1064694039,266166534,274520883,1153447108,3253984783,47,38,46,55,22,30
"2590","0000","COUNTY TOTAL",15780975024,14109418,2726466,NA,"2017"," TX","County Total","48409","San Patricio",702950361,292056841,294783307,717059779,16483925385,20,24,27,18,40,39
"2591","0000","COUNTY TOTAL",12432503,0,0,NA,"2017"," FL","County Total","12113","Santa Rosa",10037,45970,45970,10037,12442540,90,80,75,72,71,78
"2592","0000","COUNTY TOTAL",655043311,147894,336769,NA,"2017"," WA","County Total","53057","Skagit",9427938,621278,958047,9575832,664471249,66,74,68,61,90,88
"2593","0000","COUNTY TOTAL",153526965,0,0,NA,"2017"," AK","County Total","02230","Skagway",150852,7104,7104,150852,153677817,85,129,123,117,124,123
"2594","0000","COUNTY TOTAL",21976833409,37204010,17184676,NA,"2017"," WA","County Total","53061","Snohomish",1201019786,10501099,27685775,1238223796,23177853195,22,61,51,53,24,60
"2595","0000","COUNTY TOTAL",47335097596,644602474,112623389,NA,"2017"," MI","County Total","26147","St. Clair",111779243,65627842,178251231,756381717,47446876839,11,53,26,42,49,58
"2596","0000","COUNTY TOTAL",14635527579,58405031,153534604,NA,"2017"," LA","County Total","22093","St. James",105633686,328910316,482444920,164038717,14741161265,26,34,50,32,52,32
"2597","0000","COUNTY TOTAL",761628221,358606,26933,NA,"2017"," NY","County Total","36089","St. Lawrence",1823134,386052,412985,2181740,763451355,71,97,110,106,83,87
"2598","0000","COUNTY TOTAL",15803339,708889,25340,NA,"2017"," FL","County Total","12111","St. Lucie",80500,45033,70373,789389,15883839,111,86,87,93,102,77
"2599","0000","COUNTY TOTAL",493520638,8362147,1928457,NA,"2017"," LA","County Total","22101","St. Mary",138851780,14999167,16927624,147213927,632372418,52,65,58,59,51,64
"2600","0000","COUNTY TOTAL",117604006,1811787,9014500,NA,"2017"," WA","County Total","53067","Thurston",0,0,9014500,1811787,117604006,95,85,86,71,112,118
"2601","0000","COUNTY TOTAL",883813881,351546268,86726516,NA,"2017"," CA","County Total","06111","Ventura",318961500,258504348,345230864,670507768,1202775381,57,30,30,40,27,25
"2602","0000","COUNTY TOTAL",63761034,5874660,2062721,NA,"2017"," VA","County Total","51812","Virginia Beach",44340884358,9523225809,9525288530,44346759018,44404645392,19,15,72,65,8.5,9.5
"2603","0000","COUNTY TOTAL",63761034,5874660,2062721,NA,"2017"," VA","County Total","51812","Virginia Beach",4452457,7239683,9302404,10327117,68213491,19,15,72,65,8.5,9.5
"2604","0000","COUNTY TOTAL",27004027667,21339673966,9723725706,NA,"2017"," VA","County Total","51811","Virginia Beach",44340884358,9523225809,19246951515,65680558324,71344912025,9,7,5,6,8.5,9.5
"2605","0000","COUNTY TOTAL",27004027667,21339673966,9723725706,NA,"2017"," VA","County Total","51811","Virginia Beach",4452457,7239683,9730965389,21344126423,27008480124,9,7,5,6,8.5,9.5
"2606","0000","COUNTY TOTAL",263218,0,0,NA,"2017"," WV","County Total","51813","Virginia Beach",0,0,0,0,263218,151,145.5,142.5,142.5,143.5,143.5
"2607","0000","COUNTY TOTAL",435392599,0,0,NA,"2017"," NC","County Total","37183","Wake",0,0,0,0,435392599,82,145.5,142.5,142.5,143.5,143.5
"2608","0000","COUNTY TOTAL",16373368,137096,95548,NA,"2017"," ME","County Total","23027","Waldo",10026397,41332921,41428469,10163493,26399765,104,72,105,98,65,67
"2609","0000","COUNTY TOTAL",1450726384,1704230,1039604,NA,"2017"," ME","County Total","23029","Washington",0,0,1039604,1704230,1450726384,59,66,62,51,101,98
"2610","0000","COUNTY TOTAL",5033247805,36148439,115770561,NA,"2017"," OR","County Total","41067","Washington",8069283,27314431,143084992,44217722,5041317088,43,26,29,27,29,33
"2611","0000","COUNTY TOTAL",178140917,49657342,1956159,NA,"2017"," WI","County Total","55133","Waukesha",5335875,389966,2346125,54993217,183476792,91,75,65,86,72,69
"2612","0000","COUNTY TOTAL",315560,0,0,NA,"2017"," NY","County Total","36117","Wayne",31240,3850,3850,31240,346800,137,131,142.5,142.5,122,121
"2613","0000","COUNTY TOTAL",7562692558,90606462,380238797,NA,"2017"," LA","County Total","22121","West Baton Rouge",79612730,264722624,644961421,170219192,7642305288,33,31,53,31,43,29
"2614","0000","COUNTY TOTAL",17567187567,51231327,7564863,NA,"2017"," WA","County Total","53073","Whatcom",8179106,891348,8456211,59410433,17575366673,24,69,47,56,68,80
"2615","0000","COUNTY TOTAL",625753968,0,0,NA,"2017"," OH","County Total","39173","Wood",10725758,4424320,4424320,10725758,636479726,74,64,81,68,64,59
"2616","0000","COUNTY TOTAL",43306926,2654271,123324,NA,"2017"," MA","County Total","25027","Worcester",0,0,123324,2654271,43306926,102,115,96,102,143.5,143.5
"2617","0000","COUNTY TOTAL",2396807,2198607,655677,NA,"2017"," AK","County Total","02275","Wrangell",6052,4497,660174,2204659,2402859,132,87,67,73,125,130
"2618","0000","COUNTY TOTAL",843717290,0,0,NA,"2017"," NC","County Total","45091","York",0,0,0,0,843717290,72,145.5,142.5,142.5,143.5,143.5
"2619","0000","COUNTY TOTAL",21512602289,17521093858,8130184871,NA,"2018"," CA","County Total","06001","Alameda",28155639582,7023016338,15153201209,45676733440,49668241871,10,5,7,7,7,6
"2620","0000","COUNTY TOTAL",263098475,2625793,317712,NA,"2018"," NY","County Total","36001","Albany",107914249,95990553,96308265,110540042,371012724,76,56,61,77,57,48
"2621","0000","COUNTY TOTAL",121904706,0,0,NA,"2018"," PA","County Total","42003","Allegheny",0,0,0,0,121904706,98,145.5,142.5,142.5,143.5,143.5
"2622","0000","COUNTY TOTAL",10714047,0,0,NA,"2018"," MI","County Total","26007","Alpena",33066,3898,3898,33066,10747113,126,135,127,130,129,125
"2623","0000","COUNTY TOTAL",13814197,5245662,1093006,NA,"2018"," MD","County Total","24003","Anne Arundel",3784543,939760,2032766,9030205,17598740,114,91,73,81,76,83
"2624","0000","COUNTY TOTAL",7297595935,3693188,470473,NA,"2018"," DC","County Total","51013","Arlington",27407778,5631716,6102189,31100966,7325003713,40,81,77,84,66,74
"2625","0000","COUNTY TOTAL",1104219202,0,0,NA,"2018"," ME","County Total","23003","Aroostook",0,0,0,0,1104219202,64,145.5,142.5,142.5,143.5,143.5
"2626","0000","COUNTY TOTAL",4718275937,2530317778,1652916254,NA,"2018"," AL","County Total","01003","Baldwin",4308605633,1216775116,2869691370,6838923411,9026881570,30,18,18,15,18,19
"2627","0000","COUNTY TOTAL",16735659605,6558360568,2464501078,NA,"2018"," MD","County Total","24005","Baltimore",20606614449,5409441145,7873942223,27164975017,37342274054,15,11,12,12,10,7
"2628","0000","COUNTY TOTAL",471976664,207203323,66933568,NA,"2018"," FL","County Total","12005","Bay",548083261,115979720,182913288,755286584,1020059925,63,47,34,43,31,45
"2629","0000","COUNTY TOTAL",7883448492,1004010374,1448953772,NA,"2018"," TX","County Total","48039","Brazoria",163334878,308611089,1757564861,1167345252,8046783370,38,23,25,19,41,34
"2630","0000","COUNTY TOTAL",34257176,7721941,2654371,NA,"2018"," FL","County Total","12009","Brevard",29897930,62215566,64869937,37619871,64155106,92,58,66,63,60,51
"2631","0000","COUNTY TOTAL",410358,374667,38227,NA,"2018"," MA","County Total","25005","Bristol",28626227,1318403,1356630,29000894,29036585,124,92,98,105,77,79
"2632","0000","COUNTY TOTAL",34058419201,30872764177,10367027383,NA,"2018"," NY","County Total","36005","Bronx",8518754321,2466980742,12834008125,39391518498,42577173522,14,8,3,5,13,16
"2633","0000","COUNTY TOTAL",12670738069,10365561357,2074775130,NA,"2018"," FL","County Total","12011","Broward",9712108145,3237302973,5312078103,20077669502,22382846214,21,14,9,14,15,14
"2634","0000","COUNTY TOTAL",301298375,75430,47883,NA,"2018"," WI","County Total","55009","Brown",202780,25110000,25157883,278210,301501155,86,71,90,95,84,66
"2635","0000","COUNTY TOTAL",4637314087,2483962665,535312476,NA,"2018"," PA","County Total","42017","Bucks",9640383509,3201888231,3737200707,12124346174,14277697596,27,16,17,24,14,13
"2636","0000","COUNTY TOTAL",29389323,0,0,NA,"2018"," LA","County Total","22017","Caddo ",0,0,0,0,29389323,109,145.5,142.5,142.5,143.5,143.5
"2637","0000","COUNTY TOTAL",9331596012,7435369,37848657,NA,"2018"," LA","County Total","22019","Calcasieu",98929895,416149860,453998517,106365264,9430525907,35,41,48,34,47,36
"2638","0000","COUNTY TOTAL",1129925944,0,0,NA,"2018"," TX","County Total","48057","Calhoun",244097272,344592676,344592676,244097272,1374023216,67,43,63,46,44,35
"2639","0000","COUNTY TOTAL",9506468941,14666296,24546609,NA,"2018"," TX","County Total","22023","Cameron",9570394,20871420,45418029,24236690,9516039335,32,36,49,28,53,43
"2640","0000","COUNTY TOTAL",651005140,962373,25266,NA,"2018"," NC","County Total","37031","Carteret",179059016,142171615,142196881,180021389,830064156,79,54,95,79,42,47
"2641","0000","COUNTY TOTAL",8065983218,499966133,450436068,NA,"2018"," TX","County Total","48071","Chambers",395551,201409,450637477,500361684,8066378769,37,40,28,25,82,75
"2642","0000","COUNTY TOTAL",34178141668,17963746184,7288296909,NA,"2018"," SC","County Total","45019","Charleston",43448641149,7955987401,15244284310,61412387333,77626782817,6,6,8,8,4,5
"2643","0000","COUNTY TOTAL",13386,13386,11536,NA,"2018"," MS","County Total","05017","Chicot",16730,5047,16583,30116,30116,152,120,122,120,114,108
"2644","0000","COUNTY TOTAL",1350809428,8757176,141213,NA,"2018"," MI","County Total","26033","Chippewa",0,0,141213,8757176,1350809428,62,73,79,96,94,68
"2645","0000","COUNTY TOTAL",88805694,0,0,NA,"2018"," WA","County Total","53009","Clallam",94490,11550,11550,94490,88900184,93,116,117,111,107,106
"2646","0000","COUNTY TOTAL",2252403938,39187922,57796187,NA,"2018"," WA","County Total","53011","Clark",9288894,4637078,62433265,48476816,2261692832,53,48,52,38,58,56
"2647","0000","COUNTY TOTAL",32773078,49905,14964,NA,"2018"," OR","County Total","41007","Clatsop",593154,168628,183592,643059,33366232,105,105,101,101,86,91
"2648","0000","COUNTY TOTAL",20736563427,0,0,NA,"2018"," GA","County Total","13067","Cobb",0,0,0,0,20736563427,25,145.5,142.5,142.5,143.5,143.5
"2649","0000","COUNTY TOTAL",1002194611,40175770,41397813,NA,"2018"," CA","County Total","06013","Contra Costa",125311564,7839971,49237784,165487334,1127506175,68,59,57,49,45,62
"2650","0000","COUNTY TOTAL",188113150,0,0,NA,"2018"," OR","County Total","41011","Coos",71205,16705,16705,71205,188184355,89,79,104,69,113,81
"2651","0000","COUNTY TOTAL",6104215753,14698348,30019569,NA,"2018"," WA","County Total","53015","Cowlitz",14691254,15319989,45339558,29389602,6118907007,39,46,55,33,59,54
"2652","0000","COUNTY TOTAL",351645487,223857150,42024600,NA,"2018"," ME","County Total","23005","Cumberland",492322222,132131488,174156088,716179372,843967709,70,49,35,50,36,46
"2653","0000","COUNTY TOTAL",36499535360,25826249,7646864,NA,"2018"," OH","County Total","39035","Cuyahoga",146038057,57083426,64730290,171864306,36645573417,16,60,59,64,46,53
"2654","0000","COUNTY TOTAL",2785689737,2070016971,252481427,NA,"2018"," PA","County Total","42045","Delaware",4381287966,772722983,1025204410,6451304937,7166977703,45,27,21,35,21,26
"2655","0000","COUNTY TOTAL",985016,70232,3594,NA,"2018"," MI","County Total","26041","Delta",58442,2760,6354,128674,1043458,140,123,126,129,109,109
"2656","0000","COUNTY TOTAL",83954,47414,8916,NA,"2018"," MD","County Total","24019","Dorchester",79740,9978,18894,127154,163694,120,111,120,122,92,94
"2657","0000","COUNTY TOTAL",458296003,1425732,535420,NA,"2018"," WI","County Total","55031","Douglas",99272285,6563152,7098572,100698017,557568288,77,68,84,78,56,61
"2658","0000","COUNTY TOTAL",52236390692,213734472,59542468,NA,"2018"," IL","County Total","17043","DuPage",649419874,142165553,201708021,863154346,52885810566,8,45,39,45,35,38
"2659","0000","COUNTY TOTAL",28250122504,22616376924,13928695368,NA,"2018"," GA","County Total","13103","Effingham",69241674386,14123904661,28052600029,91858051310,97491796890,4,2,6,3,2,2
"2660","0000","COUNTY TOTAL",42302788222,241600209,23531009,NA,"2018"," NY","County Total","36029","Erie",63874614,14793741,38324750,305474823,42366662836,13,63,33,52,55,63
"2661","0000","COUNTY TOTAL",8104473,0,0,NA,"2018"," OH","County Total","39043","Erie",37084,3726,3726,37084,8141557,108,109,142.5,142.5,85,92
"2662","0000","COUNTY TOTAL",2854973,0,0,NA,"2018"," PA","County Total","42049","Erie",4194452,1231000,1231000,4194452,7049425,113,94,113,125,73,85
"2663","0000","COUNTY TOTAL",1338390,1280199,798362,NA,"2018"," MA","County Total","25009","Essex",2592600,111454,909816,3872799,3930990,125,90,88,83,75,82
"2664","0000","COUNTY TOTAL",32322300,0,0,NA,"2018"," AK","County Total","02090","Fairbanks North Star",0,0,0,0,32322300,117,121,119,108,143.5,143.5
"2665","0000","COUNTY TOTAL",65701039,677043,45660,NA,"2018"," VA","County Total","51059","Fairfax",16956,54,45714,693999,65717995,107,107,108,92,123,120
"2666","0000","COUNTY TOTAL",3430991,15690,648,NA,"2018"," CT","County Total","09001","Fairfield",500391,37631,38279,516081,3931382,134,126,121,116,121,117
"2667","0000","COUNTY TOTAL",911991736,0,0,NA,"2018"," OH","County Total","39045","Fairfield",0,0,0,0,911991736,81,145.5,142.5,142.5,143.5,143.5
"2668","0000","COUNTY TOTAL",13218814,0,0,NA,"2018"," NC","County Total","37067","Forsyth",0,0,0,0,13218814,103,145.5,142.5,142.5,143.5,143.5
"2669","0000","COUNTY TOTAL",2653096503,199150783,87875117,NA,"2018"," TX","County Total","48167","Galveston",462149903,384486937,472362054,661300686,3115246406,49,37,37,41,32,31
"2670","0000","COUNTY TOTAL",1286513,329452,107706,NA,"2018"," SC","County Total","45043","Georgetown",7855742,1442109,1549815,8185194,9142255,133,93,97,97,81,86
"2671","0000","COUNTY TOTAL",5183923611,102640154,25754437,NA,"2018"," GA","County Total","13127","Glynn",582486851,42086854,67841291,685127005,5766410462,36,52,32,44,30,52
"2672","0000","COUNTY TOTAL",1472434776,306735533,22164692,NA,"2018"," WA","County Total","53027","Grays Harbor",712297,161378,22326070,307447830,1473147073,55,67,40,57,62,70
"2673","0000","COUNTY TOTAL",6590473033,0,0,NA,"2018"," OH","County Total","39061","Hamilton",0,0,0,0,6590473033,41,145.5,142.5,142.5,143.5,143.5
"2674","0000","COUNTY TOTAL",16241962524,418718851,553213955,NA,"2018"," TX","County Total","48199","Hardin",41671416,134875384,688089339,460390267,16283633940,29,39,41,30,50,37
"2675","0000","COUNTY TOTAL",1020647991,958499478,680160297,NA,"2018"," MS","County Total","28047","Harrison",1424586030,823969133,1504129430,2383085508,2445234021,51,22,24,21,23,22
"2676","0000","COUNTY TOTAL",226354501,382972,79807,NA,"2018"," CT","County Total","09003","Hartford",284759,29277,109084,667731,226639260,83,114,112,115,87,101
"2677","0000","COUNTY TOTAL",274240542,9105814,5508809,NA,"2018"," HI","County Total","15001","Hawaii",4177428,270167,5778976,13283242,278417970,88,77,64,60,95,95
"2678","0000","COUNTY TOTAL",1344256503,0,0,NA,"2018"," MN","County Total","27054","Hennepin",0,0,0,0,1344256503,61,145.5,142.5,142.5,143.5,143.5
"2679","0000","COUNTY TOTAL",1966206327,72600955,96314548,NA,"2018"," FL","County Total","12057","Hillsborough",1038477516,561138873,657453421,1111078471,3004683843,50,32,44,39,25,27
"2680","0000","COUNTY TOTAL",450913880,99821122,148080173,NA,"2018"," HI","County Total","15003","Honolulu",666145093,1205362895,1353443068,765966215,1117058973,69,25,43,37,34,24
"2681","0000","COUNTY TOTAL",251609544,11324709,2889874,NA,"2018"," AK","County Total","02105","Hoonah-Angoon",268455,41425,2931299,11593164,251877999,84,103,82,89,108,119
"2682","0000","COUNTY TOTAL",32109283,5175,2761,NA,"2018"," CA","County Total","06023","Humboldt",545032,108965,111726,550207,32654315,116,82,103,66,89,97
"2683","0000","COUNTY TOTAL",3161209747,377773175,491181876,NA,"2018"," MS","County Total","28059","Jackson",12067817,5512991,496694867,389840992,3173277564,48,42,31,26,69,84
"2684","0000","COUNTY TOTAL",92385653,0,0,NA,"2018"," AL","County Total","01073","Jefferson",0,0,0,0,92385653,100,145.5,142.5,142.5,143.5,143.5
"2685","0000","COUNTY TOTAL",7119170139,8638864,1304719,NA,"2018"," NY","County Total","36045","Jefferson",2172426,139429,1444148,10811290,7121342565,34,96,69,82,78,99
"2686","0000","COUNTY TOTAL",2138168,317053,759,NA,"2018"," WA","County Total","53031","Jefferson",24750,5522,6281,341803,2162918,87,101,38,88,98,111
"2687","0000","COUNTY TOTAL",5914054,0,0,NA,"2018"," MI","County Total","26081","Kent",0,0,0,0,5914054,128,145.5,142.5,142.5,143.5,143.5
"2688","0000","COUNTY TOTAL",64116871,497164,170108,NA,"2018"," AK","County Total","02130","Ketchikan Gateway",301135,131809,301917,798299,64418006,99,99,89,90,97,90
"2689","0000","COUNTY TOTAL",9099148250,5899944741,4767668067,NA,"2018"," WA","County Total","53035","Kitsap",20299924452,4916049008,9683717075,26199869193,29399072702,17,10,14,10,11,11
"2690","0000","COUNTY TOTAL",4796946842,110559155,76055793,NA,"2018"," MN","County Total","27071","Koochiching",442949814,112255605,188311398,553508969,5239896656,44,44,42,36,33,42
"2691","0000","COUNTY TOTAL",3245887,19219,7204,NA,"2018"," OR","County Total","41041","Lincoln",0,0,7204,19219,3245887,135,100,83,87,128,128
"2692","0000","COUNTY TOTAL",10773201,0,0,NA,"2018"," OH","County Total","39093","Lorain",15878,4010,4010,15878,10789079,122,117,125,127,99,107
"2693","0000","COUNTY TOTAL",35813488809,32797829599,17466278809,NA,"2018"," CA","County Total","06037","Los Angeles",236602119218,39461931904,56928210713,269399948817,272415608027,1,1,1,1,1,1
"2694","0000","COUNTY TOTAL",113196,0,0,NA,"2018"," MS","County Total","22065","Madison",0,0,0,0,113196,148,124,142.5,142.5,120,113
"2695","0000","COUNTY TOTAL",105918007,37550618,49990311,NA,"2018"," FL","County Total","12081","Manatee",249378306,381777483,431767794,286928924,355296313,80,35,60,47,38,28
"2696","0000","COUNTY TOTAL",1272488,327470,125470,NA,"2018"," WI","County Total","55071","Manitowoc",59650,4200,129670,387120,1332138,150,122,111,109,126,129
"2697","0000","COUNTY TOTAL",437009,29248,5455,NA,"2018"," WI","County Total","55075","Marinette",0,0,5455,29248,437009,144,130,107,119,132,131
"2698","0000","COUNTY TOTAL",113161571,0,0,NA,"2018"," MI","County Total","26103","Marquette",12858,4800,4800,12858,113174429,96,125,142.5,142.5,106,114
"2699","0000","COUNTY TOTAL",21189263195,1323501521,530058484,NA,"2018"," AK","County Total","02170","Matanuska-Susitna",25474957,46391004,576449488,1348976478,21214738152,23,33,20,22,61,57
"2700","0000","COUNTY TOTAL",5139327,2731473,2467623,NA,"2018"," HI","County Total","15009","Maui",83719,16824,2484447,2815192,5223046,121,89,76,75,105,105
"2701","0000","COUNTY TOTAL",9826889937,8247623768,2308867842,NA,"2018"," FL","County Total","12086","Miami-Dade",15101084843,3483948557,5792816399,23348708611,24927974780,18,13,10,13,12,12
"2702","0000","COUNTY TOTAL",21358633,837007,614471,NA,"2018"," FL","County Total","12087","Monroe",251555,54070,668541,1088562,21610188,106,95,78,80,100,103
"2703","0000","COUNTY TOTAL",14015993,404148,248836,NA,"2018"," NY","County Total","36055","Monroe",224652,49752,298588,628800,14240645,123,108,100,100,96,100
"2704","0000","COUNTY TOTAL",20377305,324800,49660,NA,"2018"," CA","County Total","06053","Monterey",0,0,49660,324800,20377305,131,88,80,74,111,116
"2705","0000","COUNTY TOTAL",38017274,0,0,NA,"2018"," OH","County Total","39113","Montgomery",0,0,0,0,38017274,112,145.5,142.5,142.5,143.5,143.5
"2706","0000","COUNTY TOTAL",89351738887,29872707050,13310295446,NA,"2018"," TX","County Total","48339","Montgomery",3.6733e+10,11713565199,25023860645,66605707477,126084739314,2,3,2,2,6,3
"2707","0000","COUNTY TOTAL",1289810543,1687200,126690,NA,"2018"," AL","County Total","01103","Morgan",0,0,126690,1687200,1289810543,56,106,91,91,143.5,143.5
"2708","0000","COUNTY TOTAL",612794,10000,2068,NA,"2018"," MI","County Total","26121","Muskegon",0,0,2068,10000,612794,146,112,99,107,104,102
"2709","0000","COUNTY TOTAL",6679726336,3163351752,1136656227,NA,"2018"," FL","County Total","12089","Nassau",6667644332,1996822041,3133478268,9830996084,13347370668,28,17,16,17,16,17
"2710","0000","COUNTY TOTAL",5329590576,4742730262,1410991799,NA,"2018"," NC","County Total","37129","New Hanover",3785077388,1070458208,2481450007,8527807650,9114667964,31,19,15,16,20,21
"2711","0000","COUNTY TOTAL",66660702,6000,6359,NA,"2018"," CT","County Total","09009","New Haven",8939996,10185512,10191871,8945996,75600698,97,62,85,70,67,55
"2712","0000","COUNTY TOTAL",172517,128936,38817,NA,"2018"," CT","County Total","09011","New London",13507743,19437799,19476616,13636679,13680260,118,83,102,104,80,73
"2713","0000","COUNTY TOTAL",251504,185279,15675,NA,"2018"," MA","County Total","44005","Newport",1254750,362354,378029,1440029,1506254,115,104,92,103,93,89
"2714","0000","COUNTY TOTAL",17851709,640399,91915,NA,"2018"," RI","County Total","44005","Newport",56704,31872,123787,697103,17908413,115,104,92,103,93,89
"2715","0000","COUNTY TOTAL",1264116793,962539228,833473644,NA,"2018"," MA","County Total","25021","Norfolk",4784002259,1126280386,1959754030,5746541487,6048119052,42,21,22,20,19,20
"2716","0000","COUNTY TOTAL",78866862555,68325971,19785432,NA,"2018"," MI","County Total","26125","Oakland",61252212,71027740,90813172,129578183,78928114767,5,55,36,48,48,49
"2717","0000","COUNTY TOTAL",1677061,0,0,NA,"2018"," NY","County Total","36067","Onondaga",0,0,0,0,1677061,101,145.5,142.5,142.5,143.5,143.5
"2718","0000","COUNTY TOTAL",34153150631,29855797235,12965024019,NA,"2018"," CA","County Total","06059","Orange",65489298326,11427968903,24392992922,95345095561,99642448957,3,4,4,4,3,4
"2719","0000","COUNTY TOTAL",59170272,375841,19441,NA,"2018"," TX","County Total","48361","Orange",855889,26639,46080,1231730,60026161,110,98,74,85,118,122
"2720","0000","COUNTY TOTAL",67458030565,7416719689,4194185454,NA,"2018"," LA","County Total","22071","Orleans",5308161760,2667359295,6861544749,12724881449,72766192325,7,12,13,11,17,15
"2721","0000","COUNTY TOTAL",2180155519,0,0,NA,"2018"," FL","County Total","12097","Osceola",0,0,0,0,2180155519,60,145.5,142.5,142.5,143.5,143.5
"2722","0000","COUNTY TOTAL",3122370,1847672,39952,NA,"2018"," NY","County Total","36075","Oswego",6367982,2570852,2610804,8215654,9490352,119,70,106,124,70,65
"2723","0000","COUNTY TOTAL",5883,0,0,NA,"2018"," MI","County Total","26139","Ottawa",11440,320,320,11440,17323,139,132,118,123,131,132
"2724","0000","COUNTY TOTAL",2004762642,1624730833,534678778,NA,"2018"," FL","County Total","12099","Palm Beach",236321436,121791888,656470666,1861052269,2241084078,54,29,19,23,39,41
"2725","0000","COUNTY TOTAL",907187542,387911,27301,NA,"2018"," ME","County Total","23019","Penobscot",37696,47236,74537,425607,907225238,65,84,93,99,88,76
"2726","0000","COUNTY TOTAL",1831642,0,0,NA,"2018"," IL","County Total","17143","Peoria",4574262,275550,275550,4574262,6405904,129,110,130,114,79,96
"2727","0000","COUNTY TOTAL",8881815301,6813889319,6475314391,NA,"2018"," WA","County Total","53053","Pierce",35661860146,4604610370,11079924761,42475749465,44543675447,12,9,11,9,5,8
"2728","0000","COUNTY TOTAL",84621,84621,5107,NA,"2018"," MA","County Total","25023","Plymouth",387152,27675,32782,471773,471773,147,102,109,94,103,93
"2729","0000","COUNTY TOTAL",9629026,103030,28179,NA,"2018"," IN","County Total","18127","Porter",841856,214636,242815,944886,10470882,136,119,114,118,116,110
"2730","0000","COUNTY TOTAL",342900714,11560286,33834065,NA,"2018"," RI","County Total","44007","Providence",58739614,44246365,78080430,70299900,401640328,73,51,70,62,37,44
"2731","0000","COUNTY TOTAL",261301,0,0,NA,"2018"," WI","County Total","55101","Racine",0,0,0,0,261301,141,113,94,110,115,104
"2732","0000","COUNTY TOTAL",571026,0,0,NA,"2018"," SC","County Total","45079","Richland",0,0,0,0,571026,142,145.5,142.5,142.5,143.5,143.5
"2733","0000","COUNTY TOTAL",782521358,52326998,11277007,NA,"2018"," NH","County Total","33015","Rockingham",7494237,40748760,52025767,59821235,790015595,75,57,54,58,63,50
"2734","0000","COUNTY TOTAL",1137935,0,0,NA,"2018"," MI","County Total","26145","Saginaw",402377,23320,23320,402377,1540312,130,78,129,128,91,72
"2735","0000","COUNTY TOTAL",3538747675,987058750,351613169,NA,"2018"," DE","County Total","34033","Salem",834082952,1490518706,1842131875,1821141702,4372830627,46,20,23,29,26,18
"2736","0000","COUNTY TOTAL",910201564,94609531,17845616,NA,"2018"," CA","County Total","06073","San Diego",475753620,644925220,662770836,570363151,1385955184,58,28,45,54,28,23
"2737","0000","COUNTY TOTAL",434031841,379649,117126,NA,"2018"," CA","County Total","06077","San Joaquin",57274338,123360336,123477462,57653987,491306179,78,50,71,67,54,40
"2738","0000","COUNTY TOTAL",1914194,0,0,NA,"2018"," WA","County Total","53055","San Juan",0,0,0,0,1914194,127,127,124,121,117,115
"2739","0000","COUNTY TOTAL",398577,49800,51713,NA,"2018"," CA","County Total","06079","San Luis Obispo",204121,18465,70178,253921,602698,138,118,116,113,110,112
"2740","0000","COUNTY TOTAL",1859373895,46551946,6853829,NA,"2018"," CA","County Total","06081","San Mateo",2536035123,511123557,517977386,2582587069,4395409018,47,38,46,55,22,30
"2741","0000","COUNTY TOTAL",23256776031,74370156,109140811,NA,"2018"," TX","County Total","48409","San Patricio",104949875,154790439,263931250,179320031,23361725906,20,24,27,18,40,39
"2742","0000","COUNTY TOTAL",30872795,17470067,22819989,NA,"2018"," FL","County Total","12113","Santa Rosa",6681030,4429580,27249569,24151097,37553825,90,80,75,72,71,78
"2743","0000","COUNTY TOTAL",97124,75924,16209,NA,"2018"," WI","County Total","55117","Sheboygan",0,0,16209,75924,97124,154,128,115,112,127,127
"2744","0000","COUNTY TOTAL",1192784311,12232454,30442959,NA,"2018"," WA","County Total","53057","Skagit",253318,159055,30602014,12485772,1193037629,66,74,68,61,90,88
"2745","0000","COUNTY TOTAL",225223134,170848,76228,NA,"2018"," AK","County Total","02230","Skagway",0,0,76228,170848,225223134,85,129,123,117,124,123
"2746","0000","COUNTY TOTAL",18660321957,46459896,11023322,NA,"2018"," WA","County Total","53061","Snohomish",889158484,5925238,16948560,935618380,19549480441,22,61,51,53,24,60
"2747","0000","COUNTY TOTAL",50416989706,658020554,108078803,NA,"2018"," MI","County Total","26147","St. Clair",83409636,13595881,121674684,741430190,50500399342,11,53,26,42,49,58
"2748","0000","COUNTY TOTAL",16459468881,43778187,96249188,NA,"2018"," LA","County Total","22093","St. James",97800757,361069503,457318691,141578944,16557269638,26,34,50,32,52,32
"2749","0000","COUNTY TOTAL",922059666,12876,19724,NA,"2018"," NY","County Total","36089","St. Lawrence",3552031,343920,363644,3564907,925611697,71,97,110,106,83,87
"2750","0000","COUNTY TOTAL",20424295,918568,68737,NA,"2018"," FL","County Total","12111","St. Lucie",148265,1827452,1896189,1066833,20572560,111,86,87,93,102,77
"2751","0000","COUNTY TOTAL",2091859809,100659620,38500643,NA,"2018"," LA","County Total","22101","St. Mary",93987081,76115499,114616142,194646701,2185846890,52,65,58,59,51,64
"2752","0000","COUNTY TOTAL",122761047,689589,2880509,NA,"2018"," WA","County Total","53067","Thurston",0,0,2880509,689589,122761047,95,85,86,71,112,118
"2753","0000","COUNTY TOTAL",1113651596,187352236,90607075,NA,"2018"," CA","County Total","06111","Ventura",627391922,382695146,473302221,814744158,1741043518,57,30,30,40,27,25
"2754","0000","COUNTY TOTAL",24572575421,21554140996,10705745075,NA,"2018"," VA","County Total","51811","Virginia Beach",5666424,1551178,10707296253,21559807420,24578241845,9,7,5,6,8.5,9.5
"2755","0000","COUNTY TOTAL",24572575421,21554140996,10705745075,NA,"2018"," VA","County Total","51811","Virginia Beach",47215875870,9701913964,20407659039,68770016866,71788451291,9,7,5,6,8.5,9.5
"2756","0000","COUNTY TOTAL",76529415,3842768,14691018,NA,"2018"," VA","County Total","51812","Virginia Beach",5666424,1551178,16242196,9509192,82195839,19,15,72,65,8.5,9.5
"2757","0000","COUNTY TOTAL",76529415,3842768,14691018,NA,"2018"," VA","County Total","51812","Virginia Beach",47215875870,9701913964,9716604982,47219718638,47292405285,19,15,72,65,8.5,9.5
"2758","0000","COUNTY TOTAL",1472380,0,0,NA,"2018"," WV","County Total","51813","Virginia Beach",0,0,0,0,1472380,151,145.5,142.5,142.5,143.5,143.5
"2759","0000","COUNTY TOTAL",561602233,0,0,NA,"2018"," NC","County Total","37183","Wake",0,0,0,0,561602233,82,145.5,142.5,142.5,143.5,143.5
"2760","0000","COUNTY TOTAL",23967517,69271,32189,NA,"2018"," ME","County Total","23027","Waldo",6318386,490340,522529,6387657,30285903,104,72,105,98,65,67
"2761","0000","COUNTY TOTAL",1585448302,44874774,75133078,NA,"2018"," ME","County Total","23029","Washington",1492220,144312,75277390,46366994,1586940522,59,66,62,51,101,98
"2762","0000","COUNTY TOTAL",5106404570,88213895,325747650,NA,"2018"," OR","County Total","41067","Washington",35552545,18164027,343911677,123766440,5141957115,43,26,29,27,29,33
"2763","0000","COUNTY TOTAL",98684825,22666494,989912,NA,"2018"," WI","County Total","55133","Waukesha",5373939,673674,1663586,28040433,104058764,91,75,65,86,72,69
"2764","0000","COUNTY TOTAL",223449,0,0,NA,"2018"," NY","County Total","36117","Wayne",259984,20971,20971,259984,483433,137,131,142.5,142.5,122,121
"2765","0000","COUNTY TOTAL",8833326631,218932231,496056265,NA,"2018"," LA","County Total","22121","West Baton Rouge",80388636,277020980,773077245,299320867,8913715267,33,31,53,31,43,29
"2766","0000","COUNTY TOTAL",17952040650,71641829,8215488,NA,"2018"," WA","County Total","53073","Whatcom",7889547,965460,9180948,79531376,17959930197,24,69,47,56,68,80
"2767","0000","COUNTY TOTAL",466574729,69395,43731,NA,"2018"," OH","County Total","39173","Wood",4662170,99750478,99794209,4731565,471236899,74,64,81,68,64,59
"2768","0000","COUNTY TOTAL",71552418,249269,251036,NA,"2018"," MA","County Total","25027","Worcester",0,0,251036,249269,71552418,102,115,96,102,143.5,143.5
"2769","0000","COUNTY TOTAL",768341,717639,293735,NA,"2018"," AK","County Total","02275","Wrangell",0,0,293735,717639,768341,132,87,67,73,125,130
"2770","0000","COUNTY TOTAL",944932427,0,0,NA,"2018"," NC","County Total","45091","York",0,0,0,0,944932427,72,145.5,142.5,142.5,143.5,143.5
"2771","0000","COUNTY TOTAL",22249757330,18384371242,8473245880,NA,"2019"," CA","County Total","06001","Alameda",29085667558,7019033879,15492279759,47470038800,51335424888,10,5,7,7,7,6
"2772","0000","COUNTY TOTAL",176683334,25250281,783147,NA,"2019"," NY","County Total","36001","Albany",4155873,39240011,40023158,29406154,180839207,76,56,61,77,57,48
"2773","0000","COUNTY TOTAL",177103422,0,0,NA,"2019"," PA","County Total","42003","Allegheny",0,0,0,0,177103422,98,145.5,142.5,142.5,143.5,143.5
"2774","0000","COUNTY TOTAL",2819434,260264,49827,NA,"2019"," MD","County Total","24003","Anne Arundel",3065175,1528890,1578717,3325439,5884609,114,91,73,81,76,83
"2775","0000","COUNTY TOTAL",7553511668,1421121,611482,NA,"2019"," DC","County Total","51013","Arlington",35304297,7240722,7852204,36725418,7588815965,40,81,77,84,66,74
"2776","0000","COUNTY TOTAL",1051193887,0,0,NA,"2019"," ME","County Total","23003","Aroostook",0,0,0,0,1051193887,64,145.5,142.5,142.5,143.5,143.5
"2777","0000","COUNTY TOTAL",4143075313,2490580598,2779884587,NA,"2019"," AL","County Total","01003","Baldwin",5875322147,1537230195,4317114782,8365902745,10018397460,30,18,18,15,18,19
"2778","0000","COUNTY TOTAL",14933513169,5866693782,2749813248,NA,"2019"," MD","County Total","24005","Baltimore",21028392940,5410547598,8160360846,26895086722,35961906109,15,11,12,12,10,7
"2779","0000","COUNTY TOTAL",482679416,173720632,43818329,NA,"2019"," FL","County Total","12005","Bay",492878210,114890360,158708689,666598842,975557626,63,47,34,43,31,45
"2780","0000","COUNTY TOTAL",8266034097,826811666,1206374895,NA,"2019"," TX","County Total","48039","Brazoria",179238901,281028699,1487403594,1006050567,8445272998,38,23,25,19,41,34
"2781","0000","COUNTY TOTAL",50943101,4833147,225095,NA,"2019"," FL","County Total","12009","Brevard",26241778,67030684,67255779,31074925,77184879,92,58,66,63,60,51
"2782","0000","COUNTY TOTAL",1740426,962477,57329,NA,"2019"," MA","County Total","25005","Bristol",988271,42175,99504,1950748,2728697,124,92,98,105,77,79
"2783","0000","COUNTY TOTAL",32254872403,29561070061,10121467941,NA,"2019"," NY","County Total","36005","Bronx",9637242592,2878043571,12999511512,39198312653,41892114995,14,8,3,5,13,16
"2784","0000","COUNTY TOTAL",12199694308,9964757355,1926969351,NA,"2019"," FL","County Total","12011","Broward",8380274903,2915079205,4842048556,18345032258,20579969211,21,14,9,14,15,14
"2785","0000","COUNTY TOTAL",247610422,2052621,584913,NA,"2019"," WI","County Total","55009","Brown",1740629,56797000,57381913,3793250,249351051,86,71,90,95,84,66
"2786","0000","COUNTY TOTAL",4850678558,2359678373,496989675,NA,"2019"," PA","County Total","42017","Bucks",10249824023,3317137052,3814126727,12609502396,15100502581,27,16,17,24,14,13
"2787","0000","COUNTY TOTAL",13859865,0,0,NA,"2019"," LA","County Total","22017","Caddo ",0,0,0,0,13859865,109,145.5,142.5,142.5,143.5,143.5
"2788","0000","COUNTY TOTAL",9637358461,141855148,339276602,NA,"2019"," LA","County Total","22019","Calcasieu",62541017,487447005,826723607,204396165,9699899478,35,41,48,34,47,36
"2789","0000","COUNTY TOTAL",786889861,26017938,23907220,NA,"2019"," TX","County Total","48057","Calhoun",106410617,245104257,269011477,132428555,893300478,67,43,63,46,44,35
"2790","0000","COUNTY TOTAL",8921053717,59181638,717003240,NA,"2019"," TX","County Total","22023","Cameron",29851769,34362209,751365449,89033407,8950905486,32,36,49,28,53,43
"2791","0000","COUNTY TOTAL",377178622,417888,41336,NA,"2019"," NC","County Total","37031","Carteret",110719643,106282479,106323815,111137531,487898265,79,54,95,79,42,47
"2792","0000","COUNTY TOTAL",8346744080,368547849,378465789,NA,"2019"," TX","County Total","48071","Chambers",614647,136146,378601935,369162496,8347358727,37,40,28,25,82,75
"2793","0000","COUNTY TOTAL",40077520226,17932506120,7003912511,NA,"2019"," SC","County Total","45019","Charleston",44874527124,8146601292,15150513803,62807033244,84952047350,6,6,8,8,4,5
"2794","0000","COUNTY TOTAL",83360,31191,4788,NA,"2019"," MS","County Total","05017","Chicot",624374,123030,127818,655565,707734,152,120,122,120,114,108
"2795","0000","COUNTY TOTAL",1351482727,4503560,265337,NA,"2019"," MI","County Total","26033","Chippewa",443632,54153000,54418337,4947192,1351926359,62,73,79,96,94,68
"2796","0000","COUNTY TOTAL",45836543,0,0,NA,"2019"," WA","County Total","53009","Clallam",29054,20604,20604,29054,45865597,93,116,117,111,107,106
"2797","0000","COUNTY TOTAL",2232452362,87248016,232992439,NA,"2019"," WA","County Total","53011","Clark",13032673,3764534,236756973,100280689,2245485035,53,48,52,38,58,56
"2798","0000","COUNTY TOTAL",10337764,0,0,NA,"2019"," OR","County Total","41007","Clatsop",439080,147332,147332,439080,10776844,105,105,101,101,86,91
"2799","0000","COUNTY TOTAL",21861308391,0,0,NA,"2019"," GA","County Total","13067","Cobb",0,0,0,0,21861308391,25,145.5,142.5,142.5,143.5,143.5
"2800","0000","COUNTY TOTAL",707635941,8429388,2108194,NA,"2019"," CA","County Total","06013","Contra Costa",152427054,10114498,12222692,160856442,860062995,68,59,57,49,45,62
"2801","0000","COUNTY TOTAL",163651409,0,0,NA,"2019"," OR","County Total","41011","Coos",38178,1155,1155,38178,163689587,89,79,104,69,113,81
"2802","0000","COUNTY TOTAL",5579111621,40575342,176533861,NA,"2019"," WA","County Total","53015","Cowlitz",8281196,27065384,203599245,48856538,5587392817,39,46,55,33,59,54
"2803","0000","COUNTY TOTAL",336520436,251839337,48035679,NA,"2019"," ME","County Total","23005","Cumberland",593155412,138335159,186370838,844994749,929675848,70,49,35,50,36,46
"2804","0000","COUNTY TOTAL",41088424416,22090939,6459824,NA,"2019"," OH","County Total","39035","Cuyahoga",141868868,88414529,94874353,163959807,41230293284,16,60,59,64,46,53
"2805","0000","COUNTY TOTAL",3390945419,2188742501,223820305,NA,"2019"," PA","County Total","42045","Delaware",4765743993,879338432,1103158737,6954486494,8156689412,45,27,21,35,21,26
"2806","0000","COUNTY TOTAL",684405,0,0,NA,"2019"," MI","County Total","26041","Delta",378127,79540,79540,378127,1062532,140,123,126,129,109,109
"2807","0000","COUNTY TOTAL",134901,98911,20770,NA,"2019"," MD","County Total","24019","Dorchester",2737331,353770,374540,2836242,2872232,120,111,120,122,92,94
"2808","0000","COUNTY TOTAL",531456252,312653,428990,NA,"2019"," WI","County Total","55031","Douglas",25009701,31205275,31634265,25322354,556465953,77,68,84,78,56,61
"2809","0000","COUNTY TOTAL",50398648221,260171237,93995979,NA,"2019"," IL","County Total","17043","DuPage",312176618,107627759,201623738,572347855,50710824839,8,45,39,45,35,38
"2810","0000","COUNTY TOTAL",29893610529,23964823433,13569265684,NA,"2019"," GA","County Total","13103","Effingham",73092436662,14796030075,28365295759,97057260095,1.02986e+11,4,2,6,3,2,2
"2811","0000","COUNTY TOTAL",41152557117,309525026,30623985,NA,"2019"," NY","County Total","36029","Erie",69447922,14532818,45156803,378972948,41222005039,13,63,33,52,55,63
"2812","0000","COUNTY TOTAL",7927795,0,0,NA,"2019"," OH","County Total","39043","Erie",854308,70314,70314,854308,8782103,108,109,142.5,142.5,85,92
"2813","0000","COUNTY TOTAL",15225138,0,0,NA,"2019"," PA","County Total","42049","Erie",4295331,567441,567441,4295331,19520469,113,94,113,125,73,85
"2814","0000","COUNTY TOTAL",2363635,884090,1046291,NA,"2019"," MA","County Total","25009","Essex",541718,67877,1114168,1425808,2905353,125,90,88,83,75,82
"2815","0000","COUNTY TOTAL",222534,0,0,NA,"2019"," AK","County Total","02090","Fairbanks North Star",0,0,0,0,222534,117,121,119,108,143.5,143.5
"2816","0000","COUNTY TOTAL",584846,277934,6170,NA,"2019"," VA","County Total","51059","Fairfax",0,0,6170,277934,584846,107,107,108,92,123,120
"2817","0000","COUNTY TOTAL",1701131,0,0,NA,"2019"," CT","County Total","09001","Fairfield",33177,42330,42330,33177,1734308,134,126,121,116,121,117
"2818","0000","COUNTY TOTAL",729749181,0,0,NA,"2019"," OH","County Total","39045","Fairfield",0,0,0,0,729749181,81,145.5,142.5,142.5,143.5,143.5
"2819","0000","COUNTY TOTAL",35915828,0,0,NA,"2019"," NC","County Total","37067","Forsyth",0,0,0,0,35915828,103,145.5,142.5,142.5,143.5,143.5
"2820","0000","COUNTY TOTAL",2302766794,206262236,98155547,NA,"2019"," TX","County Total","48167","Galveston",549635710,396895086,495050633,755897946,2852402504,49,37,37,41,32,31
"2821","0000","COUNTY TOTAL",4642542,117500,99015,NA,"2019"," SC","County Total","45043","Georgetown",8126880,1316980,1415995,8244380,12769422,133,93,97,97,81,86
"2822","0000","COUNTY TOTAL",5663049297,64540446,20978894,NA,"2019"," GA","County Total","13127","Glynn",804114438,68766270,89745164,868654884,6467163735,36,52,32,44,30,52
"2823","0000","COUNTY TOTAL",2077504864,604856492,67374300,NA,"2019"," WA","County Total","53027","Grays Harbor",3186839,606707,67981007,608043331,2080691703,55,67,40,57,62,70
"2824","0000","COUNTY TOTAL",7356004266,0,0,NA,"2019"," OH","County Total","39061","Hamilton",0,0,0,0,7356004266,41,145.5,142.5,142.5,143.5,143.5
"2825","0000","COUNTY TOTAL",149747,0,0,NA,"2019"," ME","County Total","23009","Hancock",0,0,0,0,149747,145,134,142.5,142.5,119,124
"2826","0000","COUNTY TOTAL",19571865924,311050996,736725479,NA,"2019"," TX","County Total","48199","Hardin",23180153,62623385,799348864,334231149,19595046077,29,39,41,30,50,37
"2827","0000","COUNTY TOTAL",925178011,869301369,632475436,NA,"2019"," MS","County Total","28047","Harrison",1430450458,759921697,1392397133,2299751827,2355628469,51,22,24,21,23,22
"2828","0000","COUNTY TOTAL",254604846,122024,901,NA,"2019"," CT","County Total","09003","Hartford",950816,28276,29177,1072840,255555662,83,114,112,115,87,101
"2829","0000","COUNTY TOTAL",95586630,13669032,6205903,NA,"2019"," HI","County Total","15001","Hawaii",184327,52155,6258058,13853359,95770957,88,77,64,60,95,95
"2830","0000","COUNTY TOTAL",1213214773,0,0,NA,"2019"," MN","County Total","27054","Hennepin",0,0,0,0,1213214773,61,145.5,142.5,142.5,143.5,143.5
"2831","0000","COUNTY TOTAL",1799457337,94258147,109560561,NA,"2019"," FL","County Total","12057","Hillsborough",1131976733,495276262,604836823,1226234880,2931434070,50,32,44,39,25,27
"2832","0000","COUNTY TOTAL",279480499,102688903,149966473,NA,"2019"," HI","County Total","15003","Honolulu",560306256,982365987,1132332460,662995159,839786755,69,25,43,37,34,24
"2833","0000","COUNTY TOTAL",229520090,0,0,NA,"2019"," AK","County Total","02105","Hoonah-Angoon",0,0,0,0,229520090,84,103,82,89,108,119
"2834","0000","COUNTY TOTAL",9270000,0,0,NA,"2019"," CA","County Total","06023","Humboldt",3336531,322276,322276,3336531,12606531,116,82,103,66,89,97
"2835","0000","COUNTY TOTAL",3003945126,339560534,484634111,NA,"2019"," MS","County Total","28059","Jackson",20100450,2696544,487330655,359660984,3024045576,48,42,31,26,69,84
"2836","0000","COUNTY TOTAL",12241081,0,0,NA,"2019"," AL","County Total","01073","Jefferson",0,0,0,0,12241081,100,145.5,142.5,142.5,143.5,143.5
"2837","0000","COUNTY TOTAL",6938803456,5631279,1184232,NA,"2019"," NY","County Total","36045","Jefferson",2201538,189893,1374125,7832817,6941004994,34,96,69,82,78,99
"2838","0000","COUNTY TOTAL",1582174,475123,8708,NA,"2019"," WA","County Total","53031","Jefferson",0,0,8708,475123,1582174,87,101,38,88,98,111
"2839","0000","COUNTY TOTAL",5328587,0,0,NA,"2019"," MI","County Total","26081","Kent",0,0,0,0,5328587,128,145.5,142.5,142.5,143.5,143.5
"2840","0000","COUNTY TOTAL",70559100,0,0,NA,"2019"," AK","County Total","02130","Ketchikan Gateway",2329,14,14,2329,70561429,99,99,89,90,97,90
"2841","0000","COUNTY TOTAL",8486159806,5923483353,4482357864,NA,"2019"," WA","County Total","53035","Kitsap",18151754488,4384932241,8867290105,24075237841,26637914294,17,10,14,10,11,11
"2842","0000","COUNTY TOTAL",517735,0,0,NA,"2019"," ME","County Total","23013","Knox",0,0,0,0,517735,149,136,142.5,142.5,130,126
"2843","0000","COUNTY TOTAL",4130629564,74069213,102160764,NA,"2019"," MN","County Total","27071","Koochiching",410386472,100920507,203081271,484455685,4541016036,44,44,42,36,33,42
"2844","0000","COUNTY TOTAL",77912,31865,5054,NA,"2019"," OR","County Total","41041","Lincoln",27021,1591,6645,58886,104933,135,100,83,87,128,128
"2845","0000","COUNTY TOTAL",15001800,0,0,NA,"2019"," OH","County Total","39093","Lorain",366106,28530,28530,366106,15367906,122,117,125,127,99,107
"2846","0000","COUNTY TOTAL",31917578574,29312675800,15991033693,NA,"2019"," CA","County Total","06037","Los Angeles",219743099736,36354229752,52345263445,249055775536,251660678310,1,1,1,1,1,1
"2847","0000","COUNTY TOTAL",6101,0,0,NA,"2019"," MS","County Total","22065","Madison",457313,78886,78886,457313,463414,148,124,142.5,142.5,120,113
"2848","0000","COUNTY TOTAL",152415434,15410346,25043245,NA,"2019"," FL","County Total","12081","Manatee",430065915,469280474,494323719,445476261,582481349,80,35,60,47,38,28
"2849","0000","COUNTY TOTAL",65701,61521,19746,NA,"2019"," WI","County Total","55071","Manitowoc",0,0,19746,61521,65701,150,122,111,109,126,129
"2850","0000","COUNTY TOTAL",69938,24598,1253,NA,"2019"," WI","County Total","55075","Marinette",0,0,1253,24598,69938,144,130,107,119,132,131
"2851","0000","COUNTY TOTAL",106631403,0,0,NA,"2019"," MI","County Total","26103","Marquette",11000,956,956,11000,106642403,96,125,142.5,142.5,106,114
"2852","0000","COUNTY TOTAL",20418668377,1289767479,472769858,NA,"2019"," AK","County Total","02170","Matanuska-Susitna",22277464,40866235,513636093,1312044943,20440945841,23,33,20,22,61,57
"2853","0000","COUNTY TOTAL",3076049,1498406,894123,NA,"2019"," HI","County Total","15009","Maui",55337,7819,901942,1553743,3131386,121,89,76,75,105,105
"2854","0000","COUNTY TOTAL",9993057242,8407816615,2434502089,NA,"2019"," FL","County Total","12086","Miami-Dade",15535443063,4009850616,6444352705,23943259678,25528500305,18,13,10,13,12,12
"2855","0000","COUNTY TOTAL",24785813,877982,287279,NA,"2019"," FL","County Total","12087","Monroe",56267,5782,293061,934249,24842080,106,95,78,80,100,103
"2856","0000","COUNTY TOTAL",9326861,941033,156797,NA,"2019"," NY","County Total","36055","Monroe",1086364,41894,198691,2027397,10413225,123,108,100,100,96,100
"2857","0000","COUNTY TOTAL",2314864,1526063,183510,NA,"2019"," CA","County Total","06053","Monterey",403200,76800,260310,1929263,2718064,131,88,80,74,111,116
"2858","0000","COUNTY TOTAL",33165723,0,0,NA,"2019"," OH","County Total","39113","Montgomery",0,0,0,0,33165723,112,145.5,142.5,142.5,143.5,143.5
"2859","0000","COUNTY TOTAL",92460457689,31158799305,15763376032,NA,"2019"," TX","County Total","48339","Montgomery",38354871091,11560900621,27324276653,69513670396,130815328780,2,3,2,2,6,3
"2860","0000","COUNTY TOTAL",1301107851,2152781,336151,NA,"2019"," AL","County Total","01103","Morgan",0,0,336151,2152781,1301107851,56,106,91,91,143.5,143.5
"2861","0000","COUNTY TOTAL",758962,0,0,NA,"2019"," MI","County Total","26121","Muskegon",1900878,388655,388655,1900878,2659840,146,112,99,107,104,102
"2862","0000","COUNTY TOTAL",6693896603,3247683793,959305611,NA,"2019"," FL","County Total","12089","Nassau",6808473729,2162753630,3122059241,10056157522,13502370332,28,17,16,17,16,17
"2863","0000","COUNTY TOTAL",5937210994,5264674907,1280654491,NA,"2019"," NC","County Total","37129","New Hanover",4196862184,902769413,2183423904,9461537091,10134073178,31,19,15,16,20,21
"2864","0000","COUNTY TOTAL",66245669,142645,267076,NA,"2019"," CT","County Total","09009","New Haven",8613975,62393875,62660951,8756620,74859644,97,62,85,70,67,55
"2865","0000","COUNTY TOTAL",1040971,651322,51317,NA,"2019"," CT","County Total","09011","New London",1938858,3992827,4044144,2590180,2979829,118,83,102,104,80,73
"2866","0000","COUNTY TOTAL",5075835,1243708,58179,NA,"2019"," MA","County Total","44005","Newport",1256421,284630,342809,2500129,6332256,115,104,92,103,93,89
"2867","0000","COUNTY TOTAL",19622247,15387,9400,NA,"2019"," RI","County Total","44005","Newport",3476444,44891,54291,3491831,23098691,115,104,92,103,93,89
"2868","0000","COUNTY TOTAL",1196275820,921646923,837513151,NA,"2019"," MA","County Total","25021","Norfolk",4846786564,1180745783,2018258934,5768433487,6043062384,42,21,22,20,19,20
"2869","0000","COUNTY TOTAL",79428498888,90261488,25408132,NA,"2019"," MI","County Total","26125","Oakland",117692877,64256524,89664656,207954365,79546191765,5,55,36,48,48,49
"2870","0000","COUNTY TOTAL",2851724,0,0,NA,"2019"," NY","County Total","36067","Onondaga",0,0,0,0,2851724,101,145.5,142.5,142.5,143.5,143.5
"2871","0000","COUNTY TOTAL",31148450647,28090687493,11543984644,NA,"2019"," CA","County Total","06059","Orange",5.3617e+10,9742980378,21286965022,81707692004,84765455158,3,4,4,4,3,4
"2872","0000","COUNTY TOTAL",44525909,135113,86650,NA,"2019"," TX","County Total","48361","Orange",0,0,86650,135113,44525909,110,98,74,85,118,122
"2873","0000","COUNTY TOTAL",68734829048,6541904174,4423079005,NA,"2019"," LA","County Total","22071","Orleans",5404523842,2715573082,7138652087,11946428016,74139352890,7,12,13,11,17,15
"2874","0000","COUNTY TOTAL",2042522915,0,0,NA,"2019"," FL","County Total","12097","Osceola",0,0,0,0,2042522915,60,145.5,142.5,142.5,143.5,143.5
"2875","0000","COUNTY TOTAL",7370739,0,0,NA,"2019"," NY","County Total","36075","Oswego",3780692,3674522,3674522,3780692,11151431,119,70,106,124,70,65
"2876","0000","COUNTY TOTAL",2012924479,1583333729,519561106,NA,"2019"," FL","County Total","12099","Palm Beach",232221146,107126153,626687259,1815554875,2245145625,54,29,19,23,39,41
"2877","0000","COUNTY TOTAL",1064356619,345391,24871,NA,"2019"," ME","County Total","23019","Penobscot",30270,372,25243,375661,1064386889,65,84,93,99,88,76
"2878","0000","COUNTY TOTAL",332167,0,0,NA,"2019"," IL","County Total","17143","Peoria",936184,102891,102891,936184,1268351,129,110,130,114,79,96
"2879","0000","COUNTY TOTAL",7950969711,6326556936,5983484417,NA,"2019"," WA","County Total","53053","Pierce",35656147392,4511024546,10494508963,41982704328,43607117103,12,9,11,9,5,8
"2880","0000","COUNTY TOTAL",149169,0,0,NA,"2019"," MA","County Total","25023","Plymouth",43078,14568,14568,43078,192247,147,102,109,94,103,93
"2881","0000","COUNTY TOTAL",219620,35880,19229,NA,"2019"," IN","County Total","18127","Porter",133599,10982,30211,169479,353219,136,119,114,118,116,110
"2882","0000","COUNTY TOTAL",333325619,7240610,1024544,NA,"2019"," RI","County Total","44007","Providence",66990753,74047330,75071874,74231363,400316372,73,51,70,62,37,44
"2883","0000","COUNTY TOTAL",708716,463791,81012,NA,"2019"," WI","County Total","55101","Racine",25800,8413,89425,489591,734516,141,113,94,110,115,104
"2884","0000","COUNTY TOTAL",1512901,0,0,NA,"2019"," SC","County Total","45079","Richland",0,0,0,0,1512901,142,145.5,142.5,142.5,143.5,143.5
"2885","0000","COUNTY TOTAL",786467656,37797478,2753849,NA,"2019"," NH","County Total","33015","Rockingham",4377716,90782404,93536253,42175194,790845372,75,57,54,58,63,50
"2886","0000","COUNTY TOTAL",6124681,0,0,NA,"2019"," MI","County Total","26145","Saginaw",4317451,8703017,8703017,4317451,10442132,130,78,129,128,91,72
"2887","0000","COUNTY TOTAL",4518210696,1206699007,367799246,NA,"2019"," DE","County Total","34033","Salem",1066284056,1902687613,2270486859,2272983063,5584494752,46,20,23,29,26,18
"2888","0000","COUNTY TOTAL",934081826,129600838,20452752,NA,"2019"," CA","County Total","06073","San Diego",465693699,676360548,696813300,595294537,1399775525,58,28,45,54,28,23
"2889","0000","COUNTY TOTAL",493025430,1002604,1662500,NA,"2019"," CA","County Total","06077","San Joaquin",27760535,52906020,54568520,28763139,520785965,78,50,71,67,54,40
"2890","0000","COUNTY TOTAL",1629129,153458,45000,NA,"2019"," WA","County Total","53055","San Juan",0,0,45000,153458,1629129,127,127,124,121,117,115
"2891","0000","COUNTY TOTAL",627734,13045,1317,NA,"2019"," CA","County Total","06079","San Luis Obispo",92485,30542,31859,105530,720219,138,118,116,113,110,112
"2892","0000","COUNTY TOTAL",6613708059,98877558,13788131,NA,"2019"," CA","County Total","06081","San Mateo",2226641926,941160766,954948897,2325519484,8840349985,47,38,46,55,22,30
"2893","0000","COUNTY TOTAL",28635953611,148833043,693518435,NA,"2019"," TX","County Total","48409","San Patricio",57059634,263353845,956872280,205892677,28693013245,20,24,27,18,40,39
"2894","0000","COUNTY TOTAL",6679783,4877364,6249267,NA,"2019"," FL","County Total","12113","Santa Rosa",3491778,1433111,7682378,8369142,10171561,90,80,75,72,71,78
"2895","0000","COUNTY TOTAL",901605039,26658043,65484667,NA,"2019"," WA","County Total","53057","Skagit",266692,119621,65604288,26924735,901871731,66,74,68,61,90,88
"2896","0000","COUNTY TOTAL",180065625,0,0,NA,"2019"," AK","County Total","02230","Skagway",0,0,0,0,180065625,85,129,123,117,124,123
"2897","0000","COUNTY TOTAL",16360842038,16714070,10883262,NA,"2019"," WA","County Total","53061","Snohomish",1101410194,10037801,20921063,1118124264,17462252232,22,61,51,53,24,60
"2898","0000","COUNTY TOTAL",46544503410,596423967,97834393,NA,"2019"," MI","County Total","26147","St. Clair",101096283,43629629,141464022,697520250,46645599693,11,53,26,42,49,58
"2899","0000","COUNTY TOTAL",13410308653,133288980,421472635,NA,"2019"," LA","County Total","22093","St. James",61674083,380049040,801521675,194963063,13471982736,26,34,50,32,52,32
"2900","0000","COUNTY TOTAL",891253677,89476,32615,NA,"2019"," NY","County Total","36089","St. Lawrence",727572,105166,137781,817048,891981249,71,97,110,106,83,87
"2901","0000","COUNTY TOTAL",19791366,420163,468231,NA,"2019"," FL","County Total","12111","St. Lucie",258598,2038048,2506279,678761,20049964,111,86,87,93,102,77
"2902","0000","COUNTY TOTAL",2898929474,59246977,14948383,NA,"2019"," LA","County Total","22101","St. Mary",266741620,22827742,37776125,325988597,3165671094,52,65,58,59,51,64
"2903","0000","COUNTY TOTAL",98089471,0,0,NA,"2019"," WA","County Total","53067","Thurston",1066356,32350,32350,1066356,99155827,95,85,86,71,112,118
"2904","0000","COUNTY TOTAL",1218281505,260807560,123048240,NA,"2019"," CA","County Total","06111","Ventura",1024834279,647116051,770164291,1285641839,2243115784,57,30,30,40,27,25
"2905","0000","COUNTY TOTAL",24743332996,22394348617,8704358523,NA,"2019"," VA","County Total","51811","Virginia Beach",48302644641,9676958778,18381317301,70696993258,73045977637,9,7,5,6,8.5,9.5
"2906","0000","COUNTY TOTAL",24743332996,22394348617,8704358523,NA,"2019"," VA","County Total","51811","Virginia Beach",11958700,1697026,8706055549,22406307317,24755291696,9,7,5,6,8.5,9.5
"2907","0000","COUNTY TOTAL",101133224,2059206,973630,NA,"2019"," VA","County Total","51812","Virginia Beach",48302644641,9676958778,9677932408,48304703847,48403777865,19,15,72,65,8.5,9.5
"2908","0000","COUNTY TOTAL",101133224,2059206,973630,NA,"2019"," VA","County Total","51812","Virginia Beach",11958700,1697026,2670656,14017906,113091924,19,15,72,65,8.5,9.5
"2909","0000","COUNTY TOTAL",235948,0,0,NA,"2019"," WV","County Total","51813","Virginia Beach",0,0,0,0,235948,151,145.5,142.5,142.5,143.5,143.5
"2910","0000","COUNTY TOTAL",318249517,0,0,NA,"2019"," NC","County Total","37183","Wake",0,0,0,0,318249517,82,145.5,142.5,142.5,143.5,143.5
"2911","0000","COUNTY TOTAL",56254379,311985,80600,NA,"2019"," ME","County Total","23027","Waldo",61094,66936,147536,373079,56315473,104,72,105,98,65,67
"2912","0000","COUNTY TOTAL",1449270835,38684315,62844598,NA,"2019"," ME","County Total","23029","Washington",380594,34794,62879392,39064909,1449651429,59,66,62,51,101,98
"2913","0000","COUNTY TOTAL",4458156373,78399198,294928204,NA,"2019"," OR","County Total","41067","Washington",71549476,6822307,301750511,149948674,4529705849,43,26,29,27,29,33
"2914","0000","COUNTY TOTAL",66990898,4291612,199676,NA,"2019"," WI","County Total","55133","Waukesha",8128556,1683683,1883359,12420168,75119454,91,75,65,86,72,69
"2915","0000","COUNTY TOTAL",13609654,0,0,NA,"2019"," NY","County Total","36117","Wayne",27991,4262,4262,27991,13637645,137,131,142.5,142.5,122,121
"2916","0000","COUNTY TOTAL",7460960888,114575698,326293073,NA,"2019"," LA","County Total","22121","West Baton Rouge",98177370,312081969,638375042,212753068,7559138258,33,31,53,31,43,29
"2917","0000","COUNTY TOTAL",17179372379,88646313,8777174,NA,"2019"," WA","County Total","53073","Whatcom",11237913,1352769,10129943,99884226,17190610292,24,69,47,56,68,80
"2918","0000","COUNTY TOTAL",361086035,17920,8084,NA,"2019"," OH","County Total","39173","Wood",11396869,50723165,50731249,11414789,372482904,74,64,81,68,64,59
"2919","0000","COUNTY TOTAL",708302,0,0,NA,"2019"," MA","County Total","25027","Worcester",0,0,0,0,708302,102,115,96,102,143.5,143.5
"2920","0000","COUNTY TOTAL",355177,290680,155775,NA,"2019"," AK","County Total","02275","Wrangell",176240,2399,158174,466920,531417,132,87,67,73,125,130
"2921","0000","COUNTY TOTAL",801956715,0,0,NA,"2019"," NC","County Total","45091","York",0,0,0,0,801956715,72,145.5,142.5,142.5,143.5,143.5
"2922","0000","COUNTY TOTAL",21919136039,19186942408,8815503756,NA,"2020"," CA","County Total","06001","Alameda",28279577753,7056600163,15872103919,47466520161,50198713792,10,5,7,7,7,6
"2923","0000","COUNTY TOTAL",152936369,66707159,2693436,NA,"2020"," NY","County Total","36001","Albany",20994554,107980415,110673851,87701713,173930923,76,56,61,77,57,48
"2924","0000","COUNTY TOTAL",97366125,0,0,NA,"2020"," PA","County Total","42003","Allegheny",0,0,0,0,97366125,98,145.5,142.5,142.5,143.5,143.5
"2925","0000","COUNTY TOTAL",2559453,0,0,NA,"2020"," MI","County Total","26007","Alpena",0,0,0,0,2559453,126,135,127,130,129,125
"2926","0000","COUNTY TOTAL",16166314,604321,150490,NA,"2020"," MD","County Total","24003","Anne Arundel",3615235,1274943,1425433,4219556,19781549,114,91,73,81,76,83
"2927","0000","COUNTY TOTAL",4518902639,4168401,730461,NA,"2020"," DC","County Total","51013","Arlington",20490326,3622972,4353433,24658727,4539392965,40,81,77,84,66,74
"2928","0000","COUNTY TOTAL",823439837,0,0,NA,"2020"," ME","County Total","23003","Aroostook",0,0,0,0,823439837,64,145.5,142.5,142.5,143.5,143.5
"2929","0000","COUNTY TOTAL",3702926396,2132517208,2580082138,NA,"2020"," AL","County Total","01003","Baldwin",6451579351,1787083707,4367165845,8584096559,10154505747,30,18,18,15,18,19
"2930","0000","COUNTY TOTAL",12658174656,5645225977,2496097328,NA,"2020"," MD","County Total","24005","Baltimore",18264561504,5326086130,7822183458,23909787481,30922736160,15,11,12,12,10,7
"2931","0000","COUNTY TOTAL",385060758,129404914,49546981,NA,"2020"," FL","County Total","12005","Bay",474243816,113791931,163338912,603648730,859304574,63,47,34,43,31,45
"2932","0000","COUNTY TOTAL",8384696208,497720188,498092739,NA,"2020"," TX","County Total","48039","Brazoria",151220487,260998674,759091413,648940675,8535916695,38,23,25,19,41,34
"2933","0000","COUNTY TOTAL",75027858,7321473,373743,NA,"2020"," FL","County Total","12009","Brevard",41904079,85312365,85686108,49225552,116931937,92,58,66,63,60,51
"2934","0000","COUNTY TOTAL",361088,304250,83677,NA,"2020"," MA","County Total","25005","Bristol",188416,7580,91257,492666,549504,124,92,98,105,77,79
"2935","0000","COUNTY TOTAL",29510958965,27539210664,9429875690,NA,"2020"," NY","County Total","36005","Bronx",8449486912,2449114764,11878990454,35988697576,37960445877,14,8,3,5,13,16
"2936","0000","COUNTY TOTAL",9661129336,7884740945,1598050462,NA,"2020"," FL","County Total","12011","Broward",7545614336,2686103915,4284154377,15430355281,17206743672,21,14,9,14,15,14
"2937","0000","COUNTY TOTAL",132929038,1276415,357819,NA,"2020"," WI","County Total","55009","Brown",7914187,39705171,40062990,9190602,140843225,86,71,90,95,84,66
"2938","0000","COUNTY TOTAL",4044206706,2104071667,479091230,NA,"2020"," PA","County Total","42017","Bucks",11642867043,3496026270,3975117500,13746938710,15687073749,27,16,17,24,14,13
"2939","0000","COUNTY TOTAL",18873558,0,0,NA,"2020"," LA","County Total","22017","Caddo ",0,0,0,0,18873558,109,145.5,142.5,142.5,143.5,143.5
"2940","0000","COUNTY TOTAL",5550472658,98663917,343266360,NA,"2020"," LA","County Total","22019","Calcasieu",191629577,124051155,467317515,290293494,5742102235,35,41,48,34,47,36
"2941","0000","COUNTY TOTAL",707517552,1745605,9853829,NA,"2020"," TX","County Total","48057","Calhoun",34210642,119789758,129643587,35956247,741728194,67,43,63,46,44,35
"2942","0000","COUNTY TOTAL",5242210565,118612231,1414206066,NA,"2020"," TX","County Total","22023","Cameron",63222975,127522816,1541728882,181835206,5305433540,32,36,49,28,53,43
"2943","0000","COUNTY TOTAL",200609207,0,0,NA,"2020"," NC","County Total","37031","Carteret",79933981,60601966,60601966,79933981,280543188,79,54,95,79,42,47
"2944","0000","COUNTY TOTAL",4434450459,248360184,724112278,NA,"2020"," TX","County Total","48071","Chambers",428742,97134,724209412,248788926,4434879201,37,40,28,25,82,75
"2945","0000","COUNTY TOTAL",30179500069,16633634095,6858244469,NA,"2020"," SC","County Total","45019","Charleston",44259538281,8222215608,15080460077,60893172376,74439038350,6,6,8,8,4,5
"2946","0000","COUNTY TOTAL",6305,6305,6004,NA,"2020"," MS","County Total","05017","Chicot",221431,36111,42115,227736,227736,152,120,122,120,114,108
"2947","0000","COUNTY TOTAL",1355371614,927284,22180,NA,"2020"," MI","County Total","26033","Chippewa",180657,22132009,22154189,1107941,1355552271,62,73,79,96,94,68
"2948","0000","COUNTY TOTAL",23497597,0,0,NA,"2020"," WA","County Total","53009","Clallam",198374,33150,33150,198374,23695971,93,116,117,111,107,106
"2949","0000","COUNTY TOTAL",2110024200,141857162,352455036,NA,"2020"," WA","County Total","53011","Clark",33144336,5641462,358096498,175001498,2143168536,53,48,52,38,58,56
"2950","0000","COUNTY TOTAL",558046,49940,9724,NA,"2020"," OR","County Total","41007","Clatsop",1319877,256726,266450,1369817,1877923,105,105,101,101,86,91
"2951","0000","COUNTY TOTAL",15489752920,0,0,NA,"2020"," GA","County Total","13067","Cobb",0,0,0,0,15489752920,25,145.5,142.5,142.5,143.5,143.5
"2952","0000","COUNTY TOTAL",361201765,3625819,679213,NA,"2020"," CA","County Total","06013","Contra Costa",344321536,21921283,22600496,347947355,705523301,68,59,57,49,45,62
"2953","0000","COUNTY TOTAL",116591199,0,0,NA,"2020"," OR","County Total","41011","Coos",0,0,0,0,116591199,89,79,104,69,113,81
"2954","0000","COUNTY TOTAL",6389625983,35393910,155042100,NA,"2020"," WA","County Total","53015","Cowlitz",70551000,113794442,268836542,105944910,6460176983,39,46,55,33,59,54
"2955","0000","COUNTY TOTAL",475523215,269103844,38278426,NA,"2020"," ME","County Total","23005","Cumberland",612965491,155125900,193404326,882069335,1088488706,70,49,35,50,36,46
"2956","0000","COUNTY TOTAL",40044113447,14577364,5515738,NA,"2020"," OH","County Total","39035","Cuyahoga",136654433,65354184,70869922,151231797,40180767880,16,60,59,64,46,53
"2957","0000","COUNTY TOTAL",2766368039,1630508039,173741184,NA,"2020"," PA","County Total","42045","Delaware",4722523733,896472414,1070213598,6353031772,7488891772,45,27,21,35,21,26
"2958","0000","COUNTY TOTAL",770032,0,0,NA,"2020"," MI","County Total","26041","Delta",0,0,0,0,770032,140,123,126,129,109,109
"2959","0000","COUNTY TOTAL",253279,42011,3857,NA,"2020"," MD","County Total","24019","Dorchester",90896,100544,104401,132907,344175,120,111,120,122,92,94
"2960","0000","COUNTY TOTAL",387347455,1171787,288591,NA,"2020"," WI","County Total","55031","Douglas",40931135,32498129,32786720,42102922,428278590,77,68,84,78,56,61
"2961","0000","COUNTY TOTAL",53419493804,175692636,91246076,NA,"2020"," IL","County Total","17043","DuPage",275119597,187349557,278595633,450812233,53694613401,8,45,39,45,35,38
"2962","0000","COUNTY TOTAL",27880752792,22748414337,13852046987,NA,"2020"," GA","County Total","13103","Effingham",72811196718,14994657647,28846704634,95559611055,100691949510,4,2,6,3,2,2
"2963","0000","COUNTY TOTAL",36796991968,377581306,22300513,NA,"2020"," NY","County Total","36029","Erie",52124135,13473500,35774013,429705441,36849116103,13,63,33,52,55,63
"2964","0000","COUNTY TOTAL",63015508,0,0,NA,"2020"," OH","County Total","39043","Erie",12933920,1132095,1132095,12933920,75949428,108,109,142.5,142.5,85,92
"2965","0000","COUNTY TOTAL",1758979,0,0,NA,"2020"," PA","County Total","42049","Erie",5589981,511092,511092,5589981,7348960,113,94,113,125,73,85
"2966","0000","COUNTY TOTAL",876073,866399,694898,NA,"2020"," MA","County Total","25009","Essex",419422,298320,993218,1285821,1295495,125,90,88,83,75,82
"2967","0000","COUNTY TOTAL",5514706,0,0,NA,"2020"," AK","County Total","02090","Fairbanks North Star",0,0,0,0,5514706,117,121,119,108,143.5,143.5
"2968","0000","COUNTY TOTAL",88031,0,0,NA,"2020"," VA","County Total","51059","Fairfax",0,0,0,0,88031,107,107,108,92,123,120
"2969","0000","COUNTY TOTAL",2742279,0,0,NA,"2020"," CT","County Total","09001","Fairfield",21276,4785,4785,21276,2763555,134,126,121,116,121,117
"2970","0000","COUNTY TOTAL",549781851,0,0,NA,"2020"," OH","County Total","39045","Fairfield",0,0,0,0,549781851,81,145.5,142.5,142.5,143.5,143.5
"2971","0000","COUNTY TOTAL",14377098,0,0,NA,"2020"," NC","County Total","37067","Forsyth",0,0,0,0,14377098,103,145.5,142.5,142.5,143.5,143.5
"2972","0000","COUNTY TOTAL",2071395013,138021054,140680822,NA,"2020"," TX","County Total","48167","Galveston",458056143,197033137,337713959,596077197,2529451156,49,37,37,41,32,31
"2973","0000","COUNTY TOTAL",1760889,735330,218392,NA,"2020"," SC","County Total","45043","Georgetown",1665087,335117,553509,2400417,3425976,133,93,97,97,81,86
"2974","0000","COUNTY TOTAL",7244331599,93343441,20775869,NA,"2020"," GA","County Total","13127","Glynn",1092319339,98780445,119556314,1185662780,8336650938,36,52,32,44,30,52
"2975","0000","COUNTY TOTAL",980846967,2788162,193726,NA,"2020"," WA","County Total","53027","Grays Harbor",619183,56297,250023,3407345,981466150,55,67,40,57,62,70
"2976","0000","COUNTY TOTAL",5117223557,0,0,NA,"2020"," OH","County Total","39061","Hamilton",0,0,0,0,5117223557,41,145.5,142.5,142.5,143.5,143.5
"2977","0000","COUNTY TOTAL",9579676716,182182839,416169660,NA,"2020"," TX","County Total","48199","Hardin",5945083,21123149,437292809,188127922,9585621799,29,39,41,30,50,37
"2978","0000","COUNTY TOTAL",654315964,637161390,628214075,NA,"2020"," MS","County Total","28047","Harrison",1031867779,808442547,1436656622,1669029169,1686183743,51,22,24,21,23,22
"2979","0000","COUNTY TOTAL",184608344,121000,1276,NA,"2020"," CT","County Total","09003","Hartford",5037437,209942,211218,5158437,189645781,83,114,112,115,87,101
"2980","0000","COUNTY TOTAL",27677134,6957742,8834239,NA,"2020"," HI","County Total","15001","Hawaii",99277,40154,8874393,7057019,27776411,88,77,64,60,95,95
"2981","0000","COUNTY TOTAL",635188695,0,0,NA,"2020"," MN","County Total","27054","Hennepin",0,0,0,0,635188695,61,145.5,142.5,142.5,143.5,143.5
"2982","0000","COUNTY TOTAL",1490224731,136064431,152525612,NA,"2020"," FL","County Total","12057","Hillsborough",1246861717,515849983,668375595,1382926148,2737086448,50,32,44,39,25,27
"2983","0000","COUNTY TOTAL",135549369,90715901,117164632,NA,"2020"," HI","County Total","15003","Honolulu",438714919,1001858851,1119023483,529430820,574264288,69,25,43,37,34,24
"2984","0000","COUNTY TOTAL",232700911,0,0,NA,"2020"," AK","County Total","02105","Hoonah-Angoon",1090995,25874,25874,1090995,233791906,84,103,82,89,108,119
"2985","0000","COUNTY TOTAL",6997316,0,0,NA,"2020"," CA","County Total","06023","Humboldt",19256,8451,8451,19256,7016572,116,82,103,66,89,97
"2986","0000","COUNTY TOTAL",2156420272,257593067,365350101,NA,"2020"," MS","County Total","28059","Jackson",440247,64740,365414841,258033314,2156860519,48,42,31,26,69,84
"2987","0000","COUNTY TOTAL",571164,0,0,NA,"2020"," AL","County Total","01073","Jefferson",0,0,0,0,571164,100,145.5,142.5,142.5,143.5,143.5
"2988","0000","COUNTY TOTAL",6749461204,1637515,504782,NA,"2020"," NY","County Total","36045","Jefferson",11738876,164866,669648,13376391,6761200080,34,96,69,82,78,99
"2989","0000","COUNTY TOTAL",1170494,0,0,NA,"2020"," WA","County Total","53031","Jefferson",56354,2178,2178,56354,1226848,87,101,38,88,98,111
"2990","0000","COUNTY TOTAL",320219,0,0,NA,"2020"," MI","County Total","26081","Kent",0,0,0,0,320219,128,145.5,142.5,142.5,143.5,143.5
"2991","0000","COUNTY TOTAL",95672696,0,0,NA,"2020"," AK","County Total","02130","Ketchikan Gateway",510373,42846,42846,510373,96183069,99,99,89,90,97,90
"2992","0000","COUNTY TOTAL",8266519276,5753841110,4382847450,NA,"2020"," WA","County Total","53035","Kitsap",16864733352,4236248098,8619095548,22618574462,25131252628,17,10,14,10,11,11
"2993","0000","COUNTY TOTAL",3423613071,97639634,202217305,NA,"2020"," MN","County Total","27071","Koochiching",393203545,91913381,294130686,490843179,3816816616,44,44,42,36,33,42
"2994","0000","COUNTY TOTAL",4590085,0,0,NA,"2020"," OH","County Total","39093","Lorain",397735,35550,35550,397735,4987820,122,117,125,127,99,107
"2995","0000","COUNTY TOTAL",28462143835,26091337606,15517154669,NA,"2020"," CA","County Total","06037","Los Angeles",211290843082,36968541774,52485696443,237382180688,2.39753e+11,1,1,1,1,1,1
"2996","0000","COUNTY TOTAL",343750,0,0,NA,"2020"," MS","County Total","22065","Madison",92997,25096,25096,92997,436747,148,124,142.5,142.5,120,113
"2997","0000","COUNTY TOTAL",72436921,16429181,48378374,NA,"2020"," FL","County Total","12081","Manatee",511905833,525467871,573846245,528335014,584342754,80,35,60,47,38,28
"2998","0000","COUNTY TOTAL",206085,0,0,NA,"2020"," WI","County Total","55071","Manitowoc",12432,800,800,12432,218517,150,122,111,109,126,129
"2999","0000","COUNTY TOTAL",1005584,879243,34641,NA,"2020"," WI","County Total","55075","Marinette",0,0,34641,879243,1005584,144,130,107,119,132,131
"3000","0000","COUNTY TOTAL",92795797,0,0,NA,"2020"," MI","County Total","26103","Marquette",0,0,0,0,92795797,96,125,142.5,142.5,106,114
"3001","0000","COUNTY TOTAL",18938518654,1036853119,391728602,NA,"2020"," AK","County Total","02170","Matanuska-Susitna",20340980,35557275,427285877,1057194099,18958859634,23,33,20,22,61,57
"3002","0000","COUNTY TOTAL",1300715,705438,1207070,NA,"2020"," HI","County Total","15009","Maui",0,0,1207070,705438,1300715,121,89,76,75,105,105
"3003","0000","COUNTY TOTAL",7931674263,6594126088,1938875012,NA,"2020"," FL","County Total","12086","Miami-Dade",1.3773e+10,4058076629,5996951641,20367122552,21704670727,18,13,10,13,12,12
"3004","0000","COUNTY TOTAL",16220652,495665,242483,NA,"2020"," FL","County Total","12087","Monroe",297322,29545,272028,792987,16517974,106,95,78,80,100,103
"3005","0000","COUNTY TOTAL",961130,283441,35815,NA,"2020"," NY","County Total","36055","Monroe",635250,130277,166092,918691,1596380,123,108,100,100,96,100
"3006","0000","COUNTY TOTAL",25205601,6597322,22261636,NA,"2020"," CA","County Total","06053","Monterey",6888,9225,22270861,6604210,25212489,131,88,80,74,111,116
"3007","0000","COUNTY TOTAL",13216700,0,0,NA,"2020"," OH","County Total","39113","Montgomery",0,0,0,0,13216700,112,145.5,142.5,142.5,143.5,143.5
"3008","0000","COUNTY TOTAL",73216790359,27543435998,15595458611,NA,"2020"," TX","County Total","48339","Montgomery",36473853123,11839640998,27435099609,64017289121,109690643482,2,3,2,2,6,3
"3009","0000","COUNTY TOTAL",1026216993,317636,68508,NA,"2020"," AL","County Total","01103","Morgan",0,0,68508,317636,1026216993,56,106,91,91,143.5,143.5
"3010","0000","COUNTY TOTAL",111469,94743,6810,NA,"2020"," MI","County Total","26121","Muskegon",5000,416,7226,99743,116469,146,112,99,107,104,102
"3011","0000","COUNTY TOTAL",5219790199,2864015200,908894575,NA,"2020"," FL","County Total","12089","Nassau",6175291316,2196888743,3105783318,9039306516,11395081515,28,17,16,17,16,17
"3012","0000","COUNTY TOTAL",4014945120,3320663858,1273976736,NA,"2020"," NC","County Total","37129","New Hanover",4004428457,937094443,2211071179,7325092315,8019373577,31,19,15,16,20,21
"3013","0000","COUNTY TOTAL",114335349,52548,5977,NA,"2020"," CT","County Total","09009","New Haven",7038977,130078085,130084062,7091525,121374326,97,62,85,70,67,55
"3014","0000","COUNTY TOTAL",97950756,981946,88660,NA,"2020"," CT","County Total","09011","New London",0,0,88660,981946,97950756,118,83,102,104,80,73
"3015","0000","COUNTY TOTAL",47497293,207668,32557,NA,"2020"," MA","County Total","44005","Newport",2142071,430008,462565,2349739,49639364,115,104,92,103,93,89
"3016","0000","COUNTY TOTAL",2166596,185200,49500,NA,"2020"," RI","County Total","44005","Newport",1660899,379492,428992,1846099,3827495,115,104,92,103,93,89
"3017","0000","COUNTY TOTAL",1070142769,818919129,887374025,NA,"2020"," MA","County Total","25021","Norfolk",4470790486,1085704556,1973078581,5289709615,5540933255,42,21,22,20,19,20
"3018","0000","COUNTY TOTAL",68784299092,88926785,21138297,NA,"2020"," MI","County Total","26125","Oakland",116526157,71048242,92186539,205452942,68900825249,5,55,36,48,48,49
"3019","0000","COUNTY TOTAL",711426,0,0,NA,"2020"," NY","County Total","36067","Onondaga",0,0,0,0,711426,101,145.5,142.5,142.5,143.5,143.5
"3020","0000","COUNTY TOTAL",28972701203,26449283967,11312094860,NA,"2020"," CA","County Total","06059","Orange",56599908185,10949919083,22262013943,83049192152,85572609388,3,4,4,4,3,4
"3021","0000","COUNTY TOTAL",65134667357,5970667522,4291947536,NA,"2020"," LA","County Total","22071","Orleans",4850886641,2485768476,6777716012,10821554163,69985553998,7,12,13,11,17,15
"3022","0000","COUNTY TOTAL",964407080,0,0,NA,"2020"," FL","County Total","12097","Osceola",0,0,0,0,964407080,60,145.5,142.5,142.5,143.5,143.5
"3023","0000","COUNTY TOTAL",1903340,0,0,NA,"2020"," NY","County Total","36075","Oswego",8197657,7120458,7120458,8197657,10100997,119,70,106,124,70,65
"3024","0000","COUNTY TOTAL",7180867,0,0,NA,"2020"," MI","County Total","26139","Ottawa",0,0,0,0,7180867,139,132,118,123,131,132
"3025","0000","COUNTY TOTAL",1642058532,1380286230,500609376,NA,"2020"," FL","County Total","12099","Palm Beach",239028011,113392582,614001958,1619314241,1881086543,54,29,19,23,39,41
"3026","0000","COUNTY TOTAL",932120919,2144794,84289,NA,"2020"," ME","County Total","23019","Penobscot",235736,30132,114421,2380530,932356655,65,84,93,99,88,76
"3027","0000","COUNTY TOTAL",743264,0,0,NA,"2020"," IL","County Total","17143","Peoria",107533,63515,63515,107533,850797,129,110,130,114,79,96
"3028","0000","COUNTY TOTAL",7132674409,5045383937,4926339261,NA,"2020"," WA","County Total","53053","Pierce",29826590170,3950713338,8877052599,34871974107,36959264579,12,9,11,9,5,8
"3029","0000","COUNTY TOTAL",75502,0,0,NA,"2020"," MA","County Total","25023","Plymouth",8000,194,194,8000,83502,147,102,109,94,103,93
"3030","0000","COUNTY TOTAL",138558,13216,3369,NA,"2020"," IN","County Total","18127","Porter",828,217,3586,14044,139386,136,119,114,118,116,110
"3031","0000","COUNTY TOTAL",212325558,3076580,564496,NA,"2020"," RI","County Total","44007","Providence",743672561,145543033,146107529,746749141,955998119,73,51,70,62,37,44
"3032","0000","COUNTY TOTAL",699068,0,0,NA,"2020"," WI","County Total","55101","Racine",0,0,0,0,699068,141,113,94,110,115,104
"3033","0000","COUNTY TOTAL",12477,0,0,NA,"2020"," SC","County Total","45079","Richland",0,0,0,0,12477,142,145.5,142.5,142.5,143.5,143.5
"3034","0000","COUNTY TOTAL",179248217,1464610,818192,NA,"2020"," NH","County Total","33015","Rockingham",2879876,151201051,152019243,4344486,182128093,75,57,54,58,63,50
"3035","0000","COUNTY TOTAL",2946853,6859,1149,NA,"2020"," MI","County Total","26145","Saginaw",2890683,25880623,25881772,2897542,5837536,130,78,129,128,91,72
"3036","0000","COUNTY TOTAL",2873356539,926304099,378795455,NA,"2020"," DE","County Total","34033","Salem",1091889704,1925806646,2304602101,2018193803,3965246243,46,20,23,29,26,18
"3037","0000","COUNTY TOTAL",802400629,71806427,18649414,NA,"2020"," CA","County Total","06073","San Diego",1139714180,727063297,745712711,1211520607,1942114809,58,28,45,54,28,23
"3038","0000","COUNTY TOTAL",370587667,18177745,2048638,NA,"2020"," CA","County Total","06077","San Joaquin",29149287,46847613,48896251,47327032,399736954,78,50,71,67,54,40
"3039","0000","COUNTY TOTAL",16786221,0,0,NA,"2020"," WA","County Total","53055","San Juan",0,0,0,0,16786221,127,127,124,121,117,115
"3040","0000","COUNTY TOTAL",5249054,0,0,NA,"2020"," CA","County Total","06079","San Luis Obispo",0,0,0,0,5249054,138,118,116,113,110,112
"3041","0000","COUNTY TOTAL",4924148638,90778741,12054465,NA,"2020"," CA","County Total","06081","San Mateo",1906600292,526425304,538479769,1997379033,6830748930,47,38,46,55,22,30
"3042","0000","COUNTY TOTAL",31637090027,178131898,999742021,NA,"2020"," TX","County Total","48409","San Patricio",86703687,42953571,1042695592,264835585,31723793714,20,24,27,18,40,39
"3043","0000","COUNTY TOTAL",5560869,1197800,357311,NA,"2020"," FL","County Total","12113","Santa Rosa",19092075,2827920,3185231,20289875,24652944,90,80,75,72,71,78
"3044","0000","COUNTY TOTAL",17533,0,0,NA,"2020"," WI","County Total","55117","Sheboygan",16952,2575,2575,16952,34485,154,128,115,112,127,127
"3045","0000","COUNTY TOTAL",381933206,260377,26003,NA,"2020"," WA","County Total","53057","Skagit",16274,3720,29723,276651,381949480,66,74,68,61,90,88
"3046","0000","COUNTY TOTAL",342233785,0,0,NA,"2020"," AK","County Total","02230","Skagway",0,0,0,0,342233785,85,129,123,117,124,123
"3047","0000","COUNTY TOTAL",6180761248,34862893,45468600,NA,"2020"," WA","County Total","53061","Snohomish",818076171,15629163,61097763,852939064,6998837419,22,61,51,53,24,60
"3048","0000","COUNTY TOTAL",39185331054,483200142,83139414,NA,"2020"," MI","County Total","26147","St. Clair",104163019,48592888,131732302,587363161,39289494073,11,53,26,42,49,58
"3049","0000","COUNTY TOTAL",12143015826,64324669,266022891,NA,"2020"," LA","County Total","22093","St. James",43496001,314759472,580782363,107820670,12186511827,26,34,50,32,52,32
"3050","0000","COUNTY TOTAL",719322264,86128,80813,NA,"2020"," NY","County Total","36089","St. Lawrence",545733,162052,242865,631861,719867997,71,97,110,106,83,87
"3051","0000","COUNTY TOTAL",6708404,616386,277371,NA,"2020"," FL","County Total","12111","St. Lucie",504758,4359300,4636671,1121144,7213162,111,86,87,93,102,77
"3052","0000","COUNTY TOTAL",4039036577,25083743,5154757,NA,"2020"," LA","County Total","22101","St. Mary",77455806,8259400,13414157,102539549,4116492383,52,65,58,59,51,64
"3053","0000","COUNTY TOTAL",114636139,3414200,2639900,NA,"2020"," WA","County Total","53067","Thurston",3000,440,2640340,3417200,114639139,95,85,86,71,112,118
"3054","0000","COUNTY TOTAL",628143765,159995020,101107809,NA,"2020"," CA","County Total","06111","Ventura",1258049702,910863223,1011971032,1418044722,1886193467,57,30,30,40,27,25
"3055","0000","COUNTY TOTAL",24401590069,21666766636,8934888600,NA,"2020"," VA","County Total","51811","Virginia Beach",43108273914,8967398741,17902287341,64775040550,67509863983,9,7,5,6,8.5,9.5
"3056","0000","COUNTY TOTAL",24401590069,21666766636,8934888600,NA,"2020"," VA","County Total","51811","Virginia Beach",7770381,31213314,8966101914,21674537017,24409360450,9,7,5,6,8.5,9.5
"3057","0000","COUNTY TOTAL",129709570,1594404,506014,NA,"2020"," VA","County Total","51812","Virginia Beach",43108273914,8967398741,8967904755,43109868318,43237983484,19,15,72,65,8.5,9.5
"3058","0000","COUNTY TOTAL",129709570,1594404,506014,NA,"2020"," VA","County Total","51812","Virginia Beach",7770381,31213314,31719328,9364785,137479951,19,15,72,65,8.5,9.5
"3059","0000","COUNTY TOTAL",252985,0,0,NA,"2020"," WV","County Total","51813","Virginia Beach",0,0,0,0,252985,151,145.5,142.5,142.5,143.5,143.5
"3060","0000","COUNTY TOTAL",65277708,0,0,NA,"2020"," NC","County Total","37183","Wake",0,0,0,0,65277708,82,145.5,142.5,142.5,143.5,143.5
"3061","0000","COUNTY TOTAL",9715898,222600,222080,NA,"2020"," ME","County Total","23027","Waldo",8740975,12541996,12764076,8963575,18456873,104,72,105,98,65,67
"3062","0000","COUNTY TOTAL",1216220873,2921852,6425612,NA,"2020"," ME","County Total","23029","Washington",395383,217529,6643141,3317235,1216616256,59,66,62,51,101,98
"3063","0000","COUNTY TOTAL",4045126048,486761682,298047913,NA,"2020"," OR","County Total","41067","Washington",669890417,207934311,505982224,1156652099,4715016465,43,26,29,27,29,33
"3064","0000","COUNTY TOTAL",107790563,9302001,441856,NA,"2020"," WI","County Total","55133","Waukesha",3738585,49283331,49725187,13040586,111529148,91,75,65,86,72,69
"3065","0000","COUNTY TOTAL",6526925614,46180150,96105359,NA,"2020"," LA","County Total","22121","West Baton Rouge",70570191,495339574,591444933,116750341,6597495805,33,31,53,31,43,29
"3066","0000","COUNTY TOTAL",14937169605,70443885,8217979,NA,"2020"," WA","County Total","53073","Whatcom",4469513,358811,8576790,74913398,14941639118,24,69,47,56,68,80
"3067","0000","COUNTY TOTAL",498194199,0,0,NA,"2020"," OH","County Total","39173","Wood",24370276,11595509,11595509,24370276,522564475,74,64,81,68,64,59
"3068","0000","COUNTY TOTAL",68077768,0,0,NA,"2020"," MA","County Total","25027","Worcester",0,0,0,0,68077768,102,115,96,102,143.5,143.5
"3069","0000","COUNTY TOTAL",526352,0,0,NA,"2020"," AK","County Total","02275","Wrangell",0,0,0,0,526352,132,87,67,73,125,130
"3070","0000","COUNTY TOTAL",273015307,0,0,NA,"2020"," NC","County Total","45091","York",0,0,0,0,273015307,72,145.5,142.5,142.5,143.5,143.5
"3071","0000","COUNTY TOTAL",22642439816,19333362758,8249016433,NA,"2021"," CA","County Total","06001","Alameda",27695768493,7602480247,15851496680,47029131251,50338208309,10,5,7,7,7,6
"3072","0000","COUNTY TOTAL",257162226,90761217,3635045,NA,"2021"," NY","County Total","36001","Albany",58598316,61353872,64988917,149359533,315760542,76,56,61,77,57,48
"3073","0000","COUNTY TOTAL",117596173,0,0,NA,"2021"," PA","County Total","42003","Allegheny",0,0,0,0,117596173,98,145.5,142.5,142.5,143.5,143.5
"3074","0000","COUNTY TOTAL",1226389,0,0,NA,"2021"," MI","County Total","26007","Alpena",0,0,0,0,1226389,126,135,127,130,129,125
"3075","0000","COUNTY TOTAL",5252808,5193615,225445,NA,"2021"," MD","County Total","24003","Anne Arundel",5071039,4092627,4318072,10264654,10323847,114,91,73,81,76,83
"3076","0000","COUNTY TOTAL",7283907345,403854,80284,NA,"2021"," DC","County Total","51013","Arlington",30760146,4796841,4877125,31164000,7314667491,40,81,77,84,66,74
"3077","0000","COUNTY TOTAL",976413706,0,0,NA,"2021"," ME","County Total","23003","Aroostook",0,0,0,0,976413706,64,145.5,142.5,142.5,143.5,143.5
"3078","0000","COUNTY TOTAL",5024749086,3266291125,2142710642,NA,"2021"," AL","County Total","01003","Baldwin",8217287959,1909061288,4051771930,11483579084,13242037045,30,18,18,15,18,19
"3079","0000","COUNTY TOTAL",17040120979,7557588849,3317737831,NA,"2021"," MD","County Total","24005","Baltimore",20918115849,5805066886,9122804717,28475704698,37958236828,15,11,12,12,10,7
"3080","0000","COUNTY TOTAL",546919681,184437639,72199712,NA,"2021"," FL","County Total","12005","Bay",586332133,129426989,201626701,770769772,1133251814,63,47,34,43,31,45
"3081","0000","COUNTY TOTAL",15798758733,562076552,296508634,NA,"2021"," TX","County Total","48039","Brazoria",310864983,345593618,642102252,872941535,16109623716,38,23,25,19,41,34
"3082","0000","COUNTY TOTAL",393292534,10335629,11019511,NA,"2021"," FL","County Total","12009","Brevard",87878806,108948712,119968223,98214435,481171340,92,58,66,63,60,51
"3083","0000","COUNTY TOTAL",2253922,277023,72975,NA,"2021"," MA","County Total","25005","Bristol",947760,2521753,2594728,1224783,3201682,124,92,98,105,77,79
"3084","0000","COUNTY TOTAL",31063780024,29303376820,9750414192,NA,"2021"," NY","County Total","36005","Bronx",12857638871,3614011822,13364426014,42161015691,43921418895,14,8,3,5,13,16
"3085","0000","COUNTY TOTAL",11783301926,9956763744,2004790738,NA,"2021"," FL","County Total","12011","Broward",10174562848,3347768201,5352558939,20131326592,21957864774,21,14,9,14,15,14
"3086","0000","COUNTY TOTAL",250988604,1130344,487235,NA,"2021"," WI","County Total","55009","Brown",173186,34265,521500,1303530,251161790,86,71,90,95,84,66
"3087","0000","COUNTY TOTAL",5433087422,2616482021,669229322,NA,"2021"," PA","County Total","42017","Bucks",13123612681,4305581290,4974810612,15740094702,18556700103,27,16,17,24,14,13
"3088","0000","COUNTY TOTAL",34709673,0,0,NA,"2021"," LA","County Total","22017","Caddo ",0,0,0,0,34709673,109,145.5,142.5,142.5,143.5,143.5
"3089","0000","COUNTY TOTAL",9881492819,201464942,496137155,NA,"2021"," LA","County Total","22019","Calcasieu",687938291,261134637,757271792,889403233,10569431110,35,41,48,34,47,36
"3090","0000","COUNTY TOTAL",1168650607,3089770,4518396,NA,"2021"," TX","County Total","48057","Calhoun",60925134,66246301,70764697,64014904,1229575741,67,43,63,46,44,35
"3091","0000","COUNTY TOTAL",11226140732,200552507,341891981,NA,"2021"," TX","County Total","22023","Cameron",80431082,109297687,451189668,280983589,11306571814,32,36,49,28,53,43
"3092","0000","COUNTY TOTAL",151117146,20000,20000,NA,"2021"," NC","County Total","37031","Carteret",129576978,82640718,82660718,129596978,280694124,79,54,95,79,42,47
"3093","0000","COUNTY TOTAL",4382698375,193950526,278851170,NA,"2021"," TX","County Total","48071","Chambers",10654961,15897053,294748223,204605487,4393353336,37,40,28,25,82,75
"3094","0000","COUNTY TOTAL",29826309792,18832303688,7245766514,NA,"2021"," SC","County Total","45019","Charleston",55896046082,10153630115,17399396629,74728349770,85722355874,6,6,8,8,4,5
"3095","0000","COUNTY TOTAL",102648,102648,20160,NA,"2021"," MS","County Total","05017","Chicot",326127,25640,45800,428775,428775,152,120,122,120,114,108
"3096","0000","COUNTY TOTAL",1439559500,0,0,NA,"2021"," MI","County Total","26033","Chippewa",0,0,0,0,1439559500,62,73,79,96,94,68
"3097","0000","COUNTY TOTAL",44725496,0,0,NA,"2021"," WA","County Total","53009","Clallam",1149814,204780,204780,1149814,45875310,93,116,117,111,107,106
"3098","0000","COUNTY TOTAL",2822323115,131575700,234618615,NA,"2021"," WA","County Total","53011","Clark",42724200,20254646,254873261,174299900,2865047315,53,48,52,38,58,56
"3099","0000","COUNTY TOTAL",1135227,170451,153177,NA,"2021"," OR","County Total","41007","Clatsop",559755,85706,238883,730206,1694982,105,105,101,101,86,91
"3100","0000","COUNTY TOTAL",21625497217,0,0,NA,"2021"," GA","County Total","13067","Cobb",0,0,0,0,21625497217,25,145.5,142.5,142.5,143.5,143.5
"3101","0000","COUNTY TOTAL",24143704,1446004,96121,NA,"2021"," CA","County Total","06013","Contra Costa",596137159,79754801,79850922,597583163,620280863,68,59,57,49,45,62
"3102","0000","COUNTY TOTAL",177477399,0,0,NA,"2021"," OR","County Total","41011","Coos",33830,3453,3453,33830,177511229,89,79,104,69,113,81
"3103","0000","COUNTY TOTAL",9211358593,119110883,384172076,NA,"2021"," WA","County Total","53015","Cowlitz",207529441,204680926,588853002,326640324,9418888034,39,46,55,33,59,54
"3104","0000","COUNTY TOTAL",823825035,694666073,71066961,NA,"2021"," ME","County Total","23005","Cumberland",898398631,192327368,263394329,1593064704,1722223666,70,49,35,50,36,46
"3105","0000","COUNTY TOTAL",43641098223,29453554,6632169,NA,"2021"," OH","County Total","39035","Cuyahoga",210471852,48798133,55430302,239925406,43851570075,16,60,59,64,46,53
"3106","0000","COUNTY TOTAL",4282458877,2335114868,270115254,NA,"2021"," PA","County Total","42045","Delaware",7084235852,1066835637,1336950891,9419350720,11366694729,45,27,21,35,21,26
"3107","0000","COUNTY TOTAL",1705175,3660,186,NA,"2021"," MI","County Total","26041","Delta",44083,3763,3949,47743,1749258,140,123,126,129,109,109
"3108","0000","COUNTY TOTAL",79281642,0,0,NA,"2021"," MD","County Total","24019","Dorchester",634701,192371,192371,634701,79916343,120,111,120,122,92,94
"3109","0000","COUNTY TOTAL",434772441,2148521,1194089,NA,"2021"," WI","County Total","55031","Douglas",69413266,55202925,56397014,71561787,504185707,77,68,84,78,56,61
"3110","0000","COUNTY TOTAL",64556679366,253566503,102293833,NA,"2021"," IL","County Total","17043","DuPage",360505943,67536814,169830647,614072446,64917185309,8,45,39,45,35,38
"3111","0000","COUNTY TOTAL",30164909439,24188711333,14192600877,NA,"2021"," GA","County Total","13103","Effingham",91395838781,18690231716,32882832593,115584550114,121560748220,4,2,6,3,2,2
"3112","0000","COUNTY TOTAL",42563483030,425212020,34392418,NA,"2021"," NY","County Total","36029","Erie",64708100,22074585,56467003,489920120,42628191130,13,63,33,52,55,63
"3113","0000","COUNTY TOTAL",86901516,0,0,NA,"2021"," OH","County Total","39043","Erie",2083716,140488,140488,2083716,88985232,108,109,142.5,142.5,85,92
"3114","0000","COUNTY TOTAL",1990073,0,0,NA,"2021"," PA","County Total","42049","Erie",25661030,1454129,1454129,25661030,27651103,113,94,113,125,73,85
"3115","0000","COUNTY TOTAL",1172935,1155683,518194,NA,"2021"," MA","County Total","25009","Essex",468918,98343,616537,1624601,1641853,125,90,88,83,75,82
"3116","0000","COUNTY TOTAL",995214,90927,340000,NA,"2021"," AK","County Total","02090","Fairbanks North Star",0,0,340000,90927,995214,117,121,119,108,143.5,143.5
"3117","0000","COUNTY TOTAL",10032,0,0,NA,"2021"," VA","County Total","51059","Fairfax",0,0,0,0,10032,107,107,108,92,123,120
"3118","0000","COUNTY TOTAL",2253682,48361,3309,NA,"2021"," CT","County Total","09001","Fairfield",0,0,3309,48361,2253682,134,126,121,116,121,117
"3119","0000","COUNTY TOTAL",808643069,0,0,NA,"2021"," OH","County Total","39045","Fairfield",0,0,0,0,808643069,81,145.5,142.5,142.5,143.5,143.5
"3120","0000","COUNTY TOTAL",35693053,0,0,NA,"2021"," NC","County Total","37067","Forsyth",0,0,0,0,35693053,103,145.5,142.5,142.5,143.5,143.5
"3121","0000","COUNTY TOTAL",2570146512,197401595,94333825,NA,"2021"," TX","County Total","48167","Galveston",713840575,310402629,404736454,911242170,3283987087,49,37,37,41,32,31
"3122","0000","COUNTY TOTAL",1805968,1105103,110430,NA,"2021"," SC","County Total","45043","Georgetown",1423290,110738,221168,2528393,3229258,133,93,97,97,81,86
"3123","0000","COUNTY TOTAL",9101183024,1197665659,148229893,NA,"2021"," GA","County Total","13127","Glynn",1102986977,98676967,246906860,2300652636,10204170001,36,52,32,44,30,52
"3124","0000","COUNTY TOTAL",917254950,337269,248598,NA,"2021"," WA","County Total","53027","Grays Harbor",963713,104754,353352,1300982,918218663,55,67,40,57,62,70
"3125","0000","COUNTY TOTAL",4666515482,0,0,NA,"2021"," OH","County Total","39061","Hamilton",0,0,0,0,4666515482,41,145.5,142.5,142.5,143.5,143.5
"3126","0000","COUNTY TOTAL",1416762,0,0,NA,"2021"," ME","County Total","23009","Hancock",305571,9425,9425,305571,1722333,145,134,142.5,142.5,119,124
"3127","0000","COUNTY TOTAL",16269497237,48490106,61536209,NA,"2021"," TX","County Total","48199","Hardin",41515405,35651617,97187826,90005511,16311012642,29,39,41,30,50,37
"3128","0000","COUNTY TOTAL",876226092,854974897,576622797,NA,"2021"," MS","County Total","28047","Harrison",1481706634,1003393870,1580016667,2336681531,2357932726,51,22,24,21,23,22
"3129","0000","COUNTY TOTAL",272147414,0,0,NA,"2021"," CT","County Total","09003","Hartford",6483464,322475,322475,6483464,278630878,83,114,112,115,87,101
"3130","0000","COUNTY TOTAL",80162377,42957616,33751505,NA,"2021"," HI","County Total","15001","Hawaii",371225,96592,33848097,43328841,80533602,88,77,64,60,95,95
"3131","0000","COUNTY TOTAL",883285825,0,0,NA,"2021"," MN","County Total","27054","Hennepin",0,0,0,0,883285825,61,145.5,142.5,142.5,143.5,143.5
"3132","0000","COUNTY TOTAL",1942220946,210941933,289384997,NA,"2021"," FL","County Total","12057","Hillsborough",1596420565,971971707,1261356704,1807362498,3538641511,50,32,44,39,25,27
"3133","0000","COUNTY TOTAL",170575405,119057708,118705197,NA,"2021"," HI","County Total","15003","Honolulu",614294528,838342128,957047325,733352236,784869933,69,25,43,37,34,24
"3134","0000","COUNTY TOTAL",336849993,0,0,NA,"2021"," AK","County Total","02105","Hoonah-Angoon",0,0,0,0,336849993,84,103,82,89,108,119
"3135","0000","COUNTY TOTAL",16870387,0,0,NA,"2021"," CA","County Total","06023","Humboldt",2219441,258985,258985,2219441,19089828,116,82,103,66,89,97
"3136","0000","COUNTY TOTAL",3485249978,566678093,581796315,NA,"2021"," MS","County Total","28059","Jackson",2055350,499969,582296284,568733443,3487305328,48,42,31,26,69,84
"3137","0000","COUNTY TOTAL",256054,0,0,NA,"2021"," AL","County Total","01073","Jefferson",0,0,0,0,256054,100,145.5,142.5,142.5,143.5,143.5
"3138","0000","COUNTY TOTAL",8531479825,471413,41308,NA,"2021"," NY","County Total","36045","Jefferson",4319435,176619,217927,4790848,8535799260,34,96,69,82,78,99
"3139","0000","COUNTY TOTAL",9125403,0,0,NA,"2021"," WA","County Total","53031","Jefferson",229084,57302,57302,229084,9354487,87,101,38,88,98,111
"3140","0000","COUNTY TOTAL",13391990,0,0,NA,"2021"," MI","County Total","26081","Kent",0,0,0,0,13391990,128,145.5,142.5,142.5,143.5,143.5
"3141","0000","COUNTY TOTAL",53432221,0,0,NA,"2021"," AK","County Total","02130","Ketchikan Gateway",3874550,1566880,1566880,3874550,57306771,99,99,89,90,97,90
"3142","0000","COUNTY TOTAL",8931616095,5833096010,3923655846,NA,"2021"," WA","County Total","53035","Kitsap",21997418560,4800192529,8723848375,27830514570,30929034655,17,10,14,10,11,11
"3143","0000","COUNTY TOTAL",4649225593,102734785,144416904,NA,"2021"," MN","County Total","27071","Koochiching",501473006,126474488,270891392,604207791,5150698599,44,44,42,36,33,42
"3144","0000","COUNTY TOTAL",107668,107668,92380,NA,"2021"," OR","County Total","41041","Lincoln",11458,10025,102405,119126,119126,135,100,83,87,128,128
"3145","0000","COUNTY TOTAL",3360628,0,0,NA,"2021"," OH","County Total","39093","Lorain",1304995,60356,60356,1304995,4665623,122,117,125,127,99,107
"3146","0000","COUNTY TOTAL",26881987666,24340892419,12295956281,NA,"2021"," CA","County Total","06037","Los Angeles",242304613204,42492802824,54788759105,266645505623,269186600870,1,1,1,1,1,1
"3147","0000","COUNTY TOTAL",184202,0,0,NA,"2021"," MS","County Total","22065","Madison",297461,144857,144857,297461,481663,148,124,142.5,142.5,120,113
"3148","0000","COUNTY TOTAL",208179859,95945924,196356363,NA,"2021"," FL","County Total","12081","Manatee",701473410,855946261,1052302624,797419334,909653269,80,35,60,47,38,28
"3149","0000","COUNTY TOTAL",491838,488949,9132,NA,"2021"," WI","County Total","55075","Marinette",0,0,9132,488949,491838,144,130,107,119,132,131
"3150","0000","COUNTY TOTAL",6733479,0,0,NA,"2021"," MI","County Total","26103","Marquette",1205306,125665,125665,1205306,7938785,96,125,142.5,142.5,106,114
"3151","0000","COUNTY TOTAL",25064586564,1347665821,614054615,NA,"2021"," AK","County Total","02170","Matanuska-Susitna",8076445,5279843,619334458,1355742266,25072663009,23,33,20,22,61,57
"3152","0000","COUNTY TOTAL",5517730,620520,2910956,NA,"2021"," HI","County Total","15009","Maui",258716,222310,3133266,879236,5776446,121,89,76,75,105,105
"3153","0000","COUNTY TOTAL",10220029988,8726232496,2211292679,NA,"2021"," FL","County Total","12086","Miami-Dade",17288394667,4515494278,6726786957,26014627163,27508424655,18,13,10,13,12,12
"3154","0000","COUNTY TOTAL",33038797,358084,148418,NA,"2021"," FL","County Total","12087","Monroe",760263,48105,196523,1118347,33799060,106,95,78,80,100,103
"3155","0000","COUNTY TOTAL",3288999,0,0,NA,"2021"," NY","County Total","36055","Monroe",461347,155882,155882,461347,3750346,123,108,100,100,96,100
"3156","0000","COUNTY TOTAL",690073,685363,154009,NA,"2021"," CA","County Total","06053","Monterey",50643,1,154010,736006,740716,131,88,80,74,111,116
"3157","0000","COUNTY TOTAL",16765132,0,0,NA,"2021"," OH","County Total","39113","Montgomery",0,0,0,0,16765132,112,145.5,142.5,142.5,143.5,143.5
"3158","0000","COUNTY TOTAL",95073964512,30827920158,12473427157,NA,"2021"," TX","County Total","48339","Montgomery",50106610938,15265098346,27738525503,80934531096,145180575450,2,3,2,2,6,3
"3159","0000","COUNTY TOTAL",1274855972,176866,124494,NA,"2021"," AL","County Total","01103","Morgan",0,0,124494,176866,1274855972,56,106,91,91,143.5,143.5
"3160","0000","COUNTY TOTAL",6474953782,3775304689,1021002218,NA,"2021"," FL","County Total","12089","Nassau",6803537046,2275606028,3296608246,10578841735,13278490828,28,17,16,17,16,17
"3161","0000","COUNTY TOTAL",4949252750,4365687419,1418602102,NA,"2021"," NC","County Total","37129","New Hanover",4627292072,1212040083,2630642185,8992979491,9576544822,31,19,15,16,20,21
"3162","0000","COUNTY TOTAL",204089367,0,0,NA,"2021"," CT","County Total","09009","New Haven",50769779,65061773,65061773,50769779,254859146,97,62,85,70,67,55
"3163","0000","COUNTY TOTAL",8324232,469347,117801,NA,"2021"," CT","County Total","09011","New London",0,0,117801,469347,8324232,118,83,102,104,80,73
"3164","0000","COUNTY TOTAL",103042750,699816,53410,NA,"2021"," MA","County Total","44005","Newport",3678277,637746,691156,4378093,106721027,115,104,92,103,93,89
"3165","0000","COUNTY TOTAL",4664618,517623,27448,NA,"2021"," RI","County Total","44005","Newport",3517592,1566694,1594142,4035215,8182210,115,104,92,103,93,89
"3166","0000","COUNTY TOTAL",1377776396,1031013790,758968426,NA,"2021"," MA","County Total","25021","Norfolk",3306822873,825703454,1584671880,4337836663,4684599269,42,21,22,20,19,20
"3167","0000","COUNTY TOTAL",76717187331,105436333,25027865,NA,"2021"," MI","County Total","26125","Oakland",157363781,94478646,119506511,262800114,76874551112,5,55,36,48,48,49
"3168","0000","COUNTY TOTAL",2911784,0,0,NA,"2021"," NY","County Total","36067","Onondaga",0,0,0,0,2911784,101,145.5,142.5,142.5,143.5,143.5
"3169","0000","COUNTY TOTAL",26819420865,23527672770,10675544611,NA,"2021"," CA","County Total","06059","Orange",65842066510,12736243656,23411788267,89369739280,92661487375,3,4,4,4,3,4
"3170","0000","COUNTY TOTAL",36495,0,0,NA,"2021"," TX","County Total","48361","Orange",44062,16097,16097,44062,80557,110,98,74,85,118,122
"3171","0000","COUNTY TOTAL",80259365419,6843821434,3627798141,NA,"2021"," LA","County Total","22071","Orleans",5994399110,2719084442,6346882583,12838220544,86253764529,7,12,13,11,17,15
"3172","0000","COUNTY TOTAL",257458749,0,0,NA,"2021"," FL","County Total","12097","Osceola",0,0,0,0,257458749,60,145.5,142.5,142.5,143.5,143.5
"3173","0000","COUNTY TOTAL",3172628,0,0,NA,"2021"," NY","County Total","36075","Oswego",6766366,2498243,2498243,6766366,9938994,119,70,106,124,70,65
"3174","0000","COUNTY TOTAL",2107563729,1747413329,600026976,NA,"2021"," FL","County Total","12099","Palm Beach",346095910,164804584,764831560,2093509239,2453659639,54,29,19,23,39,41
"3175","0000","COUNTY TOTAL",1491540179,441988,127994,NA,"2021"," ME","County Total","23019","Penobscot",6081679,837632,965626,6523667,1497621858,65,84,93,99,88,76
"3176","0000","COUNTY TOTAL",1355346,0,0,NA,"2021"," IL","County Total","17143","Peoria",1914350,191372,191372,1914350,3269696,129,110,130,114,79,96
"3177","0000","COUNTY TOTAL",7871270098,5087249405,4140881017,NA,"2021"," WA","County Total","53053","Pierce",31593897753,4408544378,8549425395,36681147158,39465167851,12,9,11,9,5,8
"3178","0000","COUNTY TOTAL",75978,7780,3777,NA,"2021"," MA","County Total","25023","Plymouth",11288,1453,5230,19068,87266,147,102,109,94,103,93
"3179","0000","COUNTY TOTAL",718654,92430,15569,NA,"2021"," IN","County Total","18127","Porter",0,0,15569,92430,718654,136,119,114,118,116,110
"3180","0000","COUNTY TOTAL",324701273,2494111,483787,NA,"2021"," RI","County Total","44007","Providence",1358412605,213661388,214145175,1360906716,1683113878,73,51,70,62,37,44
"3181","0000","COUNTY TOTAL",4977840,3939177,162931,NA,"2021"," WI","County Total","55101","Racine",324306,46064,208995,4263483,5302146,141,113,94,110,115,104
"3182","0000","COUNTY TOTAL",855960,0,0,NA,"2021"," SC","County Total","45079","Richland",0,0,0,0,855960,142,145.5,142.5,142.5,143.5,143.5
"3183","0000","COUNTY TOTAL",278850747,23592060,158941,NA,"2021"," NH","County Total","33015","Rockingham",3830895,170735899,170894840,27422955,282681642,75,57,54,58,63,50
"3184","0000","COUNTY TOTAL",31349309,0,0,NA,"2021"," MI","County Total","26145","Saginaw",111561,14046000,14046000,111561,31460870,130,78,129,128,91,72
"3185","0000","COUNTY TOTAL",2923513796,1171219699,359403107,NA,"2021"," DE","County Total","34033","Salem",1162193738,1845579283,2204982390,2333413437,4085707534,46,20,23,29,26,18
"3186","0000","COUNTY TOTAL",1205304897,133656458,37421054,NA,"2021"," CA","County Total","06073","San Diego",2121472932,826446697,863867751,2255129390,3326777829,58,28,45,54,28,23
"3187","0000","COUNTY TOTAL",567386796,876716,1354272,NA,"2021"," CA","County Total","06077","San Joaquin",109438825,142228291,143582563,110315541,676825621,78,50,71,67,54,40
"3188","0000","COUNTY TOTAL",5839740,0,0,NA,"2021"," WA","County Total","53055","San Juan",0,0,0,0,5839740,127,127,124,121,117,115
"3189","0000","COUNTY TOTAL",3455410,61785,6429,NA,"2021"," CA","County Total","06079","San Luis Obispo",487985,93829,100258,549770,3943395,138,118,116,113,110,112
"3190","0000","COUNTY TOTAL",3061941931,228665192,52473136,NA,"2021"," CA","County Total","06081","San Mateo",2542867339,647584527,700057663,2771532531,5604809270,47,38,46,55,22,30
"3191","0000","COUNTY TOTAL",51471448990,361048468,967567054,NA,"2021"," TX","County Total","48409","San Patricio",60837141,96165915,1063732969,421885609,51532286131,20,24,27,18,40,39
"3192","0000","COUNTY TOTAL",13786044,1483158,457895,NA,"2021"," FL","County Total","12113","Santa Rosa",42180983,7884409,8342304,43664141,55967027,90,80,75,72,71,78
"3193","0000","COUNTY TOTAL",56998,56998,36086,NA,"2021"," WI","County Total","55117","Sheboygan",25813,3737,39823,82811,82811,154,128,115,112,127,127
"3194","0000","COUNTY TOTAL",512790185,55860,26889,NA,"2021"," WA","County Total","53057","Skagit",412206,39622,66511,468066,513202391,66,74,68,61,90,88
"3195","0000","COUNTY TOTAL",272573512,0,0,NA,"2021"," AK","County Total","02230","Skagway",281893,24318,24318,281893,272855405,85,129,123,117,124,123
"3196","0000","COUNTY TOTAL",2791082128,85047401,82570298,NA,"2021"," WA","County Total","53061","Snohomish",2029046751,155159081,237729379,2114094152,4820128879,22,61,51,53,24,60
"3197","0000","COUNTY TOTAL",49170111837,579817154,99222879,NA,"2021"," MI","County Total","26147","St. Clair",130406496,44029529,143252408,710223650,49300518333,11,53,26,42,49,58
"3198","0000","COUNTY TOTAL",14096298803,126189179,337376905,NA,"2021"," LA","County Total","22093","St. James",92073349,408217185,745594090,218262528,14188372152,26,34,50,32,52,32
"3199","0000","COUNTY TOTAL",785808024,151788,55824,NA,"2021"," NY","County Total","36089","St. Lawrence",647321,91075,146899,799109,786455345,71,97,110,106,83,87
"3200","0000","COUNTY TOTAL",19973184,109045,36926,NA,"2021"," FL","County Total","12111","St. Lucie",214560,7257476,7294402,323605,20187744,111,86,87,93,102,77
"3201","0000","COUNTY TOTAL",3677774639,17925044,4194193,NA,"2021"," LA","County Total","22101","St. Mary",117884493,19795115,23989308,135809537,3795659132,52,65,58,59,51,64
"3202","0000","COUNTY TOTAL",177549437,0,0,NA,"2021"," WA","County Total","53067","Thurston",3000,436,436,3000,177552437,95,85,86,71,112,118
"3203","0000","COUNTY TOTAL",1245266819,742326603,219595482,NA,"2021"," CA","County Total","06111","Ventura",1844885535,1134905070,1354500552,2587212138,3090152354,57,30,30,40,27,25
"3204","0000","COUNTY TOTAL",98980311,9602494,30996194,NA,"2021"," VA","County Total","51812","Virginia Beach",58564158717,11807371054,11838367248,58573761211,58663139028,19,15,72,65,8.5,9.5
"3205","0000","COUNTY TOTAL",98980311,9602494,30996194,NA,"2021"," VA","County Total","51812","Virginia Beach",9834516,10030967,41027161,19437010,108814827,19,15,72,65,8.5,9.5
"3206","0000","COUNTY TOTAL",30601520376,27419179781,10228598037,NA,"2021"," VA","County Total","51811","Virginia Beach",58564158717,11807371054,22035969091,85983338498,89165679093,9,7,5,6,8.5,9.5
"3207","0000","COUNTY TOTAL",30601520376,27419179781,10228598037,NA,"2021"," VA","County Total","51811","Virginia Beach",9834516,10030967,10238629004,27429014297,30611354892,9,7,5,6,8.5,9.5
"3208","0000","COUNTY TOTAL",8375,0,0,NA,"2021"," WV","County Total","51813","Virginia Beach",0,0,0,0,8375,151,145.5,142.5,142.5,143.5,143.5
"3209","0000","COUNTY TOTAL",35552607,0,0,NA,"2021"," NC","County Total","37183","Wake",0,0,0,0,35552607,82,145.5,142.5,142.5,143.5,143.5
"3210","0000","COUNTY TOTAL",31774117,1046582,183213,NA,"2021"," ME","County Total","23027","Waldo",31311144,41258309,41441522,32357726,63085261,104,72,105,98,65,67
"3211","0000","COUNTY TOTAL",92403,0,0,NA,"2021"," VA","County Total","51187","Warren",0,0,0,0,92403,153,145.5,142.5,142.5,143.5,143.5
"3212","0000","COUNTY TOTAL",1699699868,1937240,2703200,NA,"2021"," ME","County Total","23029","Washington",353157,256243,2959443,2290397,1700053025,59,66,62,51,101,98
"3213","0000","COUNTY TOTAL",4849094850,667946988,476059310,NA,"2021"," OR","County Total","41067","Washington",1484904488,375674982,851734292,2152851476,6333999338,43,26,29,27,29,33
"3214","0000","COUNTY TOTAL",77966585,4811584,709734,NA,"2021"," WI","County Total","55133","Waukesha",22778816,21096913,21806647,27590400,100745401,91,75,65,86,72,69
"3215","0000","COUNTY TOTAL",293433,0,0,NA,"2021"," NY","County Total","36117","Wayne",24275,633,633,24275,317708,137,131,142.5,142.5,122,121
"3216","0000","COUNTY TOTAL",7537799458,16516072,32865075,NA,"2021"," LA","County Total","22121","West Baton Rouge",88090010,241009202,273874277,104606082,7625889468,33,31,53,31,43,29
"3217","0000","COUNTY TOTAL",17555648362,68071729,9689052,NA,"2021"," WA","County Total","53073","Whatcom",36092565,4742385,14431437,104164294,17591740927,24,69,47,56,68,80
"3218","0000","COUNTY TOTAL",627635140,0,0,NA,"2021"," OH","County Total","39173","Wood",63937860,35484854,35484854,63937860,691573000,74,64,81,68,64,59
"3219","0000","COUNTY TOTAL",156649012,0,0,NA,"2021"," MA","County Total","25027","Worcester",0,0,0,0,156649012,102,115,96,102,143.5,143.5
"3220","0000","COUNTY TOTAL",1354245,0,0,NA,"2021"," AK","County Total","02275","Wrangell",0,0,0,0,1354245,132,87,67,73,125,130
"3221","0000","COUNTY TOTAL",392558288,0,0,NA,"2021"," NC","County Total","45091","York",0,0,0,0,392558288,72,145.5,142.5,142.5,143.5,143.5
"3222","0000","TOTAL FOR ALL US COASTAL PORTS",938711755531,2.44361e+11,101400796596,NA,"2013","United States","Total for all US Coastal Ports","00000","National",583962743122,117825466201,219226262797,828323786419,1.522674e+12,NA,NA,NA,NA,NA,NA
"3223","0000","TOTAL FOR ALL US COASTAL PORTS",966779486253,251995383327,101604229219,NA,"2014","United States","Total for all US Coastal Ports","00000","National",609553703106,126740664069,228344893288,861549086433,1.576333e+12,NA,NA,NA,NA,NA,NA
"3224","0000","TOTAL FOR ALL US COASTAL PORTS",874970159101,232018112387,98318543600,NA,"2015","United States","Total for all US Coastal Ports","00000","National",611157911968,134733183239,233051726839,8.43176e+11,1.486128e+12,NA,NA,NA,NA,NA,NA
"3225","0000","TOTAL FOR ALL US COASTAL PORTS",839064941952,230293806878,109348657117,NA,"2016","United States","Total for all US Coastal Ports","00000","National",604171753921,1.34926e+11,244274696753,834465560799,1.443237e+12,NA,NA,NA,NA,NA,NA
"3226","0000","TOTAL FOR ALL US COASTAL PORTS",8.98706e+11,254103593434,119665663740,NA,"2017","United States","Total for all US Coastal Ports","00000","National",636923343314,141675082952,261340746692,891026936748,1.535629e+12,NA,NA,NA,NA,NA,NA
"3227","0000","TOTAL FOR ALL US COASTAL PORTS",980993347422,275479446363,129826255614,NA,"2018","United States","Total for all US Coastal Ports","00000","National",690034092285,147681909977,277508165591,965513538648,1.671027e+12,NA,NA,NA,NA,NA,NA
"3228","0000","TOTAL FOR ALL US COASTAL PORTS",985545115037,271710544199,129108209118,NA,"2019","United States","Total for all US Coastal Ports","00000","National",672455499528,145136138071,274244347189,9.44166e+11,1.658001e+12,NA,NA,NA,NA,NA,NA
"3229","0000","TOTAL FOR ALL US COASTAL PORTS",850886368443,246743493281,125394923867,NA,"2020","United States","Total for all US Coastal Ports","00000","National",646254083285,145580192833,270975116700,892997576566,1.49714e+12,NA,NA,NA,NA,NA,NA
"3230","0000","TOTAL FOR ALL US COASTAL PORTS",1.025732e+12,273222270128,119207445073,NA,"2021","United States","Total for all US Coastal Ports","00000","National",781043314746,172481426342,291688871415,1.054266e+12,1.806776e+12,NA,NA,NA,NA,NA,NA
